weenxdxum	w ee nx dx u m 
kuurxappadxugirxadeu	k uu rx a p p a dx u g i rx a d eu 
taanxdxi	t aa nx dx i 
innum	i n n u m 
miideu	m ii d eu 
awardaan	a w a r d aa n 
adxaindta	a dx ai nd t a 
parawaa	p a r a w aa 
kuuppidxawaa	k uu p p i dx a w aa 
etxtxeukkaali	e tx tx eu k k aa l i 
seyalgalxaik	c e y a l g a lx ai k 
pirayoojanamaanawai	p i r a y oo j a n a m aa n a w ai 
piriliminari	p i r i l i m i n a r i 
puyalaaka	p u y a l aa k a 
tueukkitxtxeu	t ueu k k i tx tx eu 
un	u n 
weenla	w ee n l a 
ezhuppeu	e zh u p p eu 
porxumaiyai	p o rx u m ai y ai 
kootxi	k oo tx i 
kotxeukkappatxtxulxlxa	k o tx eu k k a p p a tx tx u lx lx a 
anjceu	a nj c eu 
rais	r ai s 
ons	o n s 
waruween	w a r u w ee n 
doocai	d oo c ai 
inxai	i nx ai 
kalagam	k a l a g a m 
adai	a d ai 
tozhil	t o zh i l 
titxtxattil	t i tx tx a t t i l 
maanxawar	m aa nx a w a r 
manaiwi	m a n ai w i 
idootxa	i d oo tx a 
kaanxbadeu	k aa nx b a d eu 
senggai	c e ng g ai 
jalam	j a l a m 
witxuwateu	w i tx u w a t eu 
seerxeu	c ee rx eu 
awagaacam	a w a g aa c a m 
waittireukka	w ai t t i r eu k k a 
piradamar	p i r a d a m a r 
wanddulxlxadeu	w a nd d u lx lx a d eu 
aaga	aa g a 
suuzhndilai	c uu zh nd i l ai 
idaiwidxa	i d ai w i dx a 
ndadxakkum	nd a dx a k k u m 
keepsxan	k ee p sx a n 
wijay	w i j a y 
wazhakkeu	w a zh a k k eu 
ndadxitteuk	nd a dx i t t eu k 
ainddeu	ai nd d eu 
ndidi	nd i d i 
maarxrxeu	m aa rx rx eu 
surxrxulaap	c u rx rx u l aa p 
nduutxuls	nd uu tx u l s 
eppa	e p p a 
waaya	w aa y a 
jipe	j i p e 
konjca	k o nj c a 
ndacceup	nd a c c u p 
sendndiir	c e nd nd ii r 
udawaateu	u d a w aa t eu 
appadawiyil	a p p a d a w i y i l 
ulxlxadaagak	u lx lx a d aa g a k 
malyutta	m a l y u t t a 
etxeukkum	e tx eu k k u m 
ireukkirxadee	i r eu k k i rx a d ee 
karxrxeukkolxlxappatxtxulxlxana	k a rx rx eu k k o lx lx a p p a tx tx u lx lx a n a 
padxam	p a dx a m 
tanxnxi	t a nx nx i 
waraada	w a r aa d a 
ungga	u ng g a 
unxaweukkeu	u nx a w eu k k eu 
tiidum	t ii d u m 
unggalx	u ng g a lx 
arxiwuraigalxai	a rx i w u r ai g a lx ai 
tanggattin	t a ng g a t t i n 
awalxudxaiya	a w a lx u dx ai y a 
purigirxadeu	p u r i g i rx a d eu 
ndigazhcciyaiyum	nd i g a zh c c i y ai y u m 
maarxrxikkolxlxudal	m aa rx rx i k k o lx lx u d a l 
paas	p aa s 
kootxtxai	k oo tx tx ai 
azhageu	a zh a g eu 
tatxtxaamee	t a tx tx aa m ee 
adeu	a d eu 
muutta	m uu t t a 
tozhilaalxar	t o zh i l aa lx a r 
ndatxaiperxrxadeu	nd a tx ai p e rx rx a d eu 
urxpatti	u rx p a t t i 
waruwadil	w a r u w a d i l 
oruttaneukkum	o r u t t a n eu k k u m 
amaidi	a m ai d i 
waanggitxtxeen	w aa ng g i tx tx ee n 
mis	m i s 
sol	c o l 
tanindabar	t a n i nd a b a r 
taalxitteu	t aa lx i t t eu 
atxtxaippadxak	a tx tx ai p p a dx a k 
puunaiyaa	p uu n ai y aa 
ueukkam	ueu k k a m 
panxnxa	p a nx nx a 
kutxikkanxum	k u tx i k k a nx u m 
kamplxiitx	k a m p lx ii tx 
waruwaangga	w a r u w aa ng g a 
teewai	t ee w ai 
ndarxumanxam	nd a rx u m a nx a m 
wilxanggaateu	w i lx a ng g aa t eu 
uuraatxcigalxil	uu r aa tx c i g a lx i l 
urxawinargalxeukkum	u rx a w i n a r g a lx eu k k u m 
sambawam	c a m b a w a m 
idanai	i d a n ai 
dxee	dx ee 
mugam	m u g a m 
uurjidam	uu r j i d a m 
aanaar	aa n aa r 
adigaarigalx	a d i g aa r i g a lx 
waitta	w ai t t a 
etxtxeu	e tx tx eu 
waanam	w aa n a m 
orkka	o r k k a 
akkaa	a k k aa 
idxam	i dx a m 
patxtxaam	p a tx tx aa m 
kaanxaada	k aa nx aa d a 
ndaappazhakkam	nd aa p p a zh a k k a m 
pirxanddaal	p i rx a nd d aa l 
weenxdxumaa	w ee nx dx u m aa 
katambam	k a t a m b a m 
waazh	w aa zh 
mugattai	m u g a t t ai 
keaanxdxeu	k e aa nx dx eu 
perugikkonxdxee	p e r u g i k k o nx dx ee 
tawarxaagiwitxtxadeu	t a w a rx aa g i w i tx tx a d eu 
adxutta	a dx u t t a 
anxnxaaweukkeu	a nx nx aa w eu k k eu 
maada	m aa d a 
poodum	p oo d u m 
tiiyaal	t ii y aa l 
tiruppik	t i r u p p i k 
awanadeu	a w a n a d eu 
saappidxuwadarxkeu	c aa p p i dx u w a d a rx k eu 
teriyaamal	t e r i y aa m a l 
tirumbiyulxlxaargalx	t i r u m b i y u lx lx aa r g a lx 
seybawargalxin	c e y b a w a r g a lx i n 
anaittum	a n ai t t u m 
maarxupatxtxa	m aa rx u p a tx tx a 
awarkuudxa	a w a r k uu dx a 
telunggeu	t e l u ng g eu 
pugaar	p u g aa r 
ndallenxnxeyyaic	nd a l l e nx nx e y y ai c 
unxdxeu	u nx dx eu 
billa	b i l l a 
paagam	p aa g a m 
ooywinrxi	oo y w i n rx i 
paanagam	p aa n a g a m 
uyar	u y a r 
iraagawan	i r aa g a w a n 
murxrxilumaaga	m u rx rx i l u m aa g a 
een	ee n 
etxeukkappootxtxi	e tx eu k k a p p oo tx tx i 
porulxillai	p o r u lx i l l ai 
warrxadeukkeu	w a r rx a d eu k k eu 
welxila	w e lx i l a 
ootxinaangga	oo tx i n aa ng g a 
kanxnxiir	k a nx nx ii r 
padxanggalxai	p a dx a ng g a lx ai 
wicaarikkum	w i c aa r i k k u m 
wiriwaana	w i r i w aa n a 
kalanddeukkonxdxanar	k a l a nd d eu k k o nx dx a n a r 
waittiyacaalaiyil	w ai t t i y a c aa l ai y i l 
kadxawulxeukkeuk	k a dx a w u lx eu k k eu k 
turxaiyinar	t u rx ai y i n a r 
samacciir	c a m a c c ii r 
kaacaawadeu	k aa c aa w a d eu 
ndamadeu	nd a m a d eu 
kizhanggin	k i zh a ng g i n 
aadarawaaga	aa d a r a w aa g a 
welxiyaagiyulxlxadeu	w e lx i y aa g i y u lx lx a d eu 
paambin	p aa m b i n 
oppiitxeu	o p p ii tx eu 
marxeukkirxaar	m a rx eu k k i rx aa r 
eerxpatxuginrxadeu	ee rx p a tx u g i n rx a d eu 
kaalakatxtxattil	k aa l a k a tx tx a t t i l 
ulawuwawai	u l a w u w a w ai 
samayapuram	c a m a y a p u r a m 
sonnaareu	c o n n aa r eu 
anjcal	a nj c a l 
ambalam	a m b a l a m 
waacanai	w aa c a n ai 
anbaree	a n b a r ee 
seydadeu	c e y d a d eu 
widxai	w i dx ai 
anaiwarumee	a n ai w a r u m ee 
awargalxin	a w a r g a lx i n 
inddak	i nd d a k 
unggalxeukkum	u ng g a lx eu k k u m 
wayirxeu	w a y i rx eu 
patteu	p a t t eu 
pooccaa	p oo c c aa 
senjcaa	c e nj c aa 
perxrxeu	p e rx rx eu 
wisxayanggalx	w i sx a y a ng g a lx 
keaatxeukkaamal	k e aa tx eu k k aa m a l 
daricananggalxaiyum	d a r i c a n a ng g a lx ai y u m 
maarxrxattai	m aa rx rx a t t ai 
waazha	w aa zh a 
ndadxanddeu	nd a dx a nd d eu 
mudalwaricai	m u d a l w a r i c ai 
konxdxaadxinar	k o nx dx aa dx i n a r 
illa	i l l a 
sanddippeu	c a nd d i p p eu 
koobam	k oo b a m 
oli	o l i 
padxiwadeu	p a dx i w a d eu 
iwalx	i w a lx 
wicaaranxaiyil	w i c aa r a nx ai y i l 
amaippaal	a m ai p p aa l 
alxawilaa	a lx a w i l aa 
anaiwarin	a n ai w a r i n 
ndagaramaana	nd a g a r a m aa n a 
armagedoon	a r m a g e d oo n 
ajiiranxak	a j ii r a nx a k 
pinni	p i n n i 
karugiyadeu	k a r u g i y a d eu 
sey	c e y 
olxi	o lx i 
ezhutteup	e zh u t t u p 
arumaiyaagawulxlxadeu	a r u m ai y aa g a w u lx lx a d eu 
azhagiyadaana	a zh a g i y a d aa n a 
wimaana	w i m aa n a 
pooliicaareukkeu	p oo l ii c aa r eu k k eu 
enrxudaan	e n rx u d aa n 
porutxkalxaip	p o r u tx k a lx ai p 
edxeu	e dx eu 
kanxnxeukkeu	k a nx nx eu k k eu 
laksxanxam	l a k sx a nx a m 
uccam	u c c a m 
padxa	p a dx a 
selaawanxi	c e l aa w a nx i 
awwidxattil	a w w i dx a t t i l 
idutodxarbaaga	i d u t o dx a r b aa g a 
wizhaa	w i zh aa 
puujaigalx	p uu j ai g a lx 
kulxiccitxtxeu	k u lx i c c i tx tx eu 
panxnxeu	p a nx nx eu 
retximeetx	r e tx i m ee tx 
ndaatxtxeu	nd aa tx tx eu 
kanddaiyaanaalum	k a nd d ai y aa n aa l u m 
pirxakkum	p i rx a k k u m 
eerxpadeu	ee rx p a d eu 
tayaarikkappatxtxana	t a y aa r i k k a p p a tx tx a n a 
unxmai	u nx m ai 
kuzhappa	k u zh a p p a 
kaappaalxiniyidxamirunddeu	k aa p p aa lx i n i y i dx a m i r u nd d eu 
toorxrxattaip	t oo rx rx a t t ai p 
elxidil	e lx i d i l 
etirtteu	e t i r t t eu 
oruwar	o r u w a r 
ellai	e l l ai 
txras	tx r a s 
ganxeesx	g a nx ee sx 
eetxtxeu	ee tx tx eu 
wenrxa	w e n rx a 
marxaiyak	m a rx ai y a k 
sinnattil	c i n n a t t i l 
rattuc	r a t t u c 
witxaadiirgalx	w i tx aa d ii r g a lx 
pugaikkum	p u g ai k k u m 
weenxtxumenrxeu	w ee nx tx u m e n rx eu 
udxambeukkeu	u dx a m b eu k k eu 
kai	k ai 
parugik	p a r u g i k 
sutxtxikkaanxpikkirxaarkalx	c u tx tx i k k aa nx p i k k i rx aa r k a lx 
talxaraamal	t a lx a r aa m a l 
araciyaleukkeu	a r a c i y a l eu k k eu 
acaamin	a c aa m i n 
munwanddeen	m u n w a nd d ee n 
keetxtxaargalx	k ee tx tx aa r g a lx 
irumal	i r u m a l 
kaarttikeeyan	k aa r t t i k ee y a n 
utxkaara	u tx k aa r a 
wanxangginaan	w a nx a ng g i n aa n 
alxaweukkeu	a lx a w eu k k eu 
tinnaadeu	t i n n aa d eu 
miinawan	m ii n a w a n 
sonnaan	c o n n aa n 
konxtxum	k o nx tx u m 
poonaan	p oo n aa n 
kaiyil	k ai y i l 
parawuwadeu	p a r a w u w a d eu 
awarxrxin	a w a rx rx i n 
eemaarxrxattai	ee m aa rx rx a t t ai 
kuzhanddaippeerxeukkaaga	k u zh a nd d ai p p ee rx eu k k aa g a 
jadxai	j a dx ai 
unxmaiyee	u nx m ai y ee 
senrxeu	c e n rx eu 
makkalx	m a k k a lx 
aanaal	aa n aa l 
ottirunddadeu	o t t i r u nd d a d eu 
inddap	i nd d a p 
kotxuppoom	k o tx u p p oo m 
payanpatxuttinaarkalx	p a y a n p a tx u t t i n aa r k a lx 
muunrxeu	m uu n rx eu 
peeaanaar	p ee aa n aa r 
unakkeuk	u n a k k eu k 
pilxatx	p i lx a tx 
litxtxar	l i tx tx a r 
taniyaa	t a n i y aa 
tootxtxattai	t oo tx tx a t t ai 
meegam	m ee g a m 
ndiikkeu	nd ii k k eu 
awaridxam	a w a r i dx a m 
seyyunggalx	c e y y u ng g a lx 
kaaranxanggalxellaam	k aa r a nx a ng g a lx e l l aa m 
muganduul	m u g a nd uu l 
poorxeen	p oo rx ee n 
wazhiyaip	w a zh i y ai p 
arxuppadeu	a rx u p p a d eu 
manx	m a nx 
pootxtxiyil	p oo tx tx i y i l 
wilai	w i l ai 
ezhutteukkalx	e zh u t t eu k k a lx 
ndawiina	nd a w ii n a 
keemaraa	k ee m a r aa 
pooliisaar	p oo l ii s aa r 
saappitxtxeu	c aa p p i tx tx eu 
hetx	h e tx 
dxelli	dx e l l i 
irunddana	i r u nd d a n a 
yoocikka	y oo c i k k a 
odeukkappatxtxa	o d eu k k a p p a tx tx a 
pootxtxeu	p oo tx tx eu 
ndiccayam	nd i c c a y a m 
unakkeu	u n a k k eu 
wisxayattaik	w i sx a y a t t ai k 
wizhunddeu	w i zh u nd d eu 
tolaikkaatxci	t o l ai k k aa tx c i 
atirsxtxam	a t i r sx tx a m 
poodee	p oo d ee 
todxarpaaga	t o dx a r p aa g a 
eelattin	ee l a t t i n 
etxutteukkolxlxunggalx	e tx u t t eu k k o lx lx u ng g a lx 
weelxaanx	w ee lx aa nx 
widikka	w i d i k k a 
seyyappatxtxeu	c e y y a p p a tx tx eu 
saappaadxeu	c aa p p aa dx eu 
manidan	m a n i d a n 
muyarxci	m u y a rx c i 
seetxtxai	c ee tx tx ai 
uunam	uu n a m 
ndiyaayam	nd i y aa y a m 
kitxaikkumee	k i tx ai k k u m ee 
kuuccal	k uu c c a l 
kiizhee	k ii zh ee 
alxawil	a lx a w i l 
aaciirwaadanggalxai	aa c ii r w aa d a ng g a lx ai 
timeuka	t i m eu k a 
enrxee	e n rx ee 
witxtxeup	w i tx tx u p 
eppoo	e p p oo 
pirxareukkeu	p i rx a r eu k k eu 
wadxiwamaippeu	w a dx i w a m ai p p eu 
alla	a l l a 
ndookki	nd oo k k i 
aarxrxalai	aa rx rx a l ai 
weelaiyum	w ee l ai y u m 
tanggalx	t a ng g a lx 
payanpatxuttik	p a y a n p a tx u t t i k 
swiitx	s w ii tx 
ndirxainddadeu	nd i rx ai nd d a d eu 
dusxtxan	d u sx tx a n 
ndilaiyam	nd i l ai y a m 
kunggumam	k u ng g u m a m 
magudxi	m a g u dx i 
mudxi	m u dx i 
warxutta	w a rx u t t a 
ndaam	nd aa m 
matxtxuminrxi	m a tx tx u m i n rx i 
wadakkawum	w a d a k k a w u m 
kadxawulxeukkeu	k a dx a w u lx eu k k eu 
uruwaagi	u r u w aa g i 
idudaan	i d u d aa n 
kaawal	k aa w a l 
welxiyidxappatxum	w e lx i y i dx a p p a tx u m 
ndalkonxdxaa	nd a l k o nx dx aa 
panxnxinaa	p a nx nx i n aa 
anubawamulxlxa	a n u b a w a m u lx lx a 
irunddaar	i r u nd d aa r 
iwai	i w ai 
kitxaiyaadeu	k i tx ai y aa d eu 
wakikkinrxana	w a k i k k i n rx a n a 
idaiyeaatxtxi	i d ai y e aa tx tx i 
porxumaikkum	p o rx u m ai k k u m 
siiwanum	c ii w a n u m 
waraangga	w a r aa ng g a 
witxudalai	w i tx u d a l ai 
uureukkeu	uu r eu k k eu 
aaltxtxoo	aa l tx tx oo 
eerxpatxtxadeu	ee rx p a tx tx a d eu 
anxiyin	a nx i y i n 
kiira	k ii r a 
anjcali	a nj c a l i 
ippadxi	i p p a dx i 
meukkiyamaana	m eu k k i y a m aa n a 
txaas	tx aa s 
kurxaiyawillai	k u rx ai y a w i l l ai 
poowadeu	p oo w a d eu 
ndanrxiyaay	nd a n rx i y aa y 
illaiyaa	i l l ai y aa 
widattil	w i d a t t i l 
kiizhppadxiyaamal	k ii zh p p a dx i y aa m a l 
sammadittaar	c a m m a d i t t aa r 
tanxtxuwadxattil	t a nx tx u w a dx a t t i l 
talxlxi	t a lx lx i 
eksaamla	e k s aa m l a 
ndekstx	nd e k s tx 
ilxamaiyil	i lx a m ai y i l 
iwar	i w a r 
selgirxadeu	c e l g i rx a d eu 
kaarai	k aa r ai 
peecaadee	p ee c aa d ee 
adxaiya	a dx ai y a 
piridal	p i r i d a l 
murxaiyaanadeu	m u rx ai y aa n a d eu 
onrxaam	o n rx aa m 
maampazham	m aa m p a zh a m 
katxtxiyawar	k a tx tx i y a w a r 
taa	t aa 
muunrxaam	m uu n rx aa m 
ippootxtxiyin	i p p oo tx tx i y i n 
maarxrxanggalx	m aa rx rx a ng g a lx 
unggalxai	u ng g a lx ai 
sonnaangga	c o n n aa ng g a 
partdxeekkeu	p a r t dx ee k k eu 
awan	a w a n 
dinamum	d i n a m u m 
tirumanxam	t i r u m a nx a m 
kotxi	k o tx i 
talaiwar	t a l ai w a r 
awareukkeu	a w a r eu k k eu 
weega	w ee g a 
kolxlxalaam	k o lx lx a l aa m 
pueukkalx	p ueu k k a lx 
ndilaiyattil	nd i l ai y a t t i l 
wej	w e j 
guloopjaamun	g u l oo p j aa m u n 
idxeu	i dx eu 
accamillaadawan	a c c a m i l l aa d a w a n 
kadxarxkaraikkeu	k a dx a rx k a r ai k k eu 
paarkkattaan	p aa r k k a t t aa n 
ndidiyudawi	nd i d i y u d a w i 
mudxiyum	m u dx i y u m 
suutaatxtxam	c uu t aa tx tx a m 
tamizhagattil	t a m i zh a g a t t i l 
sanddarppanggalx	c a nd d a r p p a ng g a lx 
poodxeu	p oo dx eu 
kaalamellaam	k aa l a m e l l aa m 
oppudal	o p p u d a l 
eppadxi	e p p a dx i 
weelai	w ee l ai 
kaaranxam	k aa r a nx a m 
doocaiyum	d oo c ai y u m 
kuuppidxungga	k uu p p i dx u ng g a 
diipaawalxikkeu	d ii p aa w a lx i k k eu 
putucaa	p u t u c aa 
panjceu	p a nj c eu 
udawum	u d a w u m 
sxasxtxi	sx a sx tx i 
usxaa	u sx aa 
kadxaleukkulx	k a dx a l eu k k u lx 
wizhaiyawillai	w i zh ai y a w i l l ai 
silareukkeu	c i l a r eu k k eu 
piriwugalx	p i r i w u g a lx 
ireukkirxadeu	i r eu k k i rx a d eu 
ulxlxadeu	u lx lx a d eu 
taralaanaar	t a r a l aa n aa r 
kuzheu	k u zh eu 
sariyaagum	c a r i y aa g u m 
warumaa	w a r u m aa 
adxaippeu	a dx ai p p eu 
karam	k a r a m 
tiitxtxeu	t ii tx tx eu 
eezhai	ee zh ai 
aaramba	aa r a m b a 
tawirkka	t a w i r k k a 
kulxircci	k u lx i r c c i 
uruwaakkiyadeu	u r u w aa k k i y a d eu 
iyareukkeu	i y a r eu k k eu 
yaar	y aa r 
uyirizhanddanar	u y i r i zh a nd d a n a r 
waricaiyaaga	w a r i c ai y aa g a 
aaraaywadan	aa r aa y w a d a n 
renxdxeu	r e nx dx eu 
laksxmi	l a k sx m i 
ndiidxikkum	nd ii dx i k k u m 
pereu	p e r eu 
kadxawulx	k a dx a w u lx 
tagawalum	t a g a w a l u m 
mooganlaal	m oo g a n l aa l 
penxgalxin	p e nx g a lx i n 
arxiwiyalilirunddeu	a rx i w i y a l i l i r u nd d eu 
ellaam	e l l aa m 
paar	p aa r 
piins	p ii n s 
wilanggeu	w i l a ng g eu 
saram	c a r a m 
kutxicai	k u tx i c ai 
wiraiwil	w i r ai w i l 
katxaigalx	k a tx ai g a lx 
wazhanggiyulxlxadeu	w a zh a ng g i y u lx lx a d eu 
wadxiwamaikkappatxtxadeu	w a dx i w a m ai k k a p p a tx tx a d eu 
padxiwanggalxai	p a dx i w a ng g a lx ai 
arulxuwaar	a r u lx u w aa r 
ndagarnddeu	nd a g a r nd d eu 
tii	t ii 
teriwittulxlxaar	t e r i w i t t u lx lx aa r 
siiraana	c ii r aa n a 
aaktxar	aa k tx a r 
dxenggeu	dx e ng g eu 
maawai	m aa w ai 
paapkaan	p aa p k aa n 
panxnxaangga	p a nx nx aa ng g a 
ndaalxaikkeu	nd aa lx ai k k eu 
baaradam	b aa r a d a m 
patxitteup	p a tx i t t u p 
yaarum	y aa r u m 
kotxeukkum	k o tx eu k k u m 
enxkaatxtxi	e nx k aa tx tx i 
wallamaimikka	w a l l a m ai m i k k a 
amaittirunddaar	a m ai t t i r u nd d aa r 
wiirargalxil	w ii r a r g a lx i l 
payirgalxai	p a y i r g a lx ai 
soolxam	c oo lx a m 
etxeukkappatxtxa	e tx eu k k a p p a tx tx a 
puzhudi	p u zh u d i 
piras	p i r a s 
pootxtxiyidxum	p oo tx tx i y i dx u m 
kaatxeu	k aa tx eu 
bajanai	b a j a n ai 
ndinaippaan	nd i n ai p p aa n 
agattin	a g a t t i n 
marunddait	m a r u nd d ai t 
ippadxattil	i p p a dx a t t i l 
wicaaranxaiyaalxaraaga	w i c aa r a nx ai y aa lx a r aa g a 
yaaraiyum	y aa r ai y u m 
enggalxeukkeu	e ng g a lx eu k k eu 
wanddaareu	w a nd d aa r eu 
waazhalaam	w aa zh a l aa m 
paccai	p a c c ai 
karumbeu	k a r u m b eu 
waarattin	w aa r a t t i n 
paaynddaal	p aa y nd d aa l 
eerxpatxtxaalum	ee rx p a tx tx aa l u m 
takawalgalx	t a k a w a l g a lx 
idai	i d ai 
tirumanxa	t i r u m a nx a 
taalxikkum	t aa lx i k k u m 
enawee	e n a w ee 
futx	f u tx 
redxiyaa	r e dx i y aa 
toguppeu	t o g u p p eu 
harisxtxam	h a r i sx tx a m 
ndutxpa	nd u tx p a 
iwarxrxai	i w a rx rx ai 
tarunxam	t a r u nx a m 
urxudiyaaka	u rx u d i y aa k a 
teriyum	t e r i y u m 
txestx	tx e s tx 
seetupadi	c ee t u p a d i 
kodxiyadeu	k o dx i y a d eu 
otxtxagam	o tx tx a g a m 
palxlxiyil	p a lx lx i y i l 
hastam	h a s t a m 
karxikkeu	k a rx i k k eu 
alxippadaaga	a lx i p p a d aa g a 
gawani	g a w a n i 
ilxainjarai	i lx ai nj a r ai 
wari	w a r i 
kaappaalxar	k aa p p aa lx a r 
keelxwigalx	k ee lx w i g a lx 
pugaippadxanggalx	p u g ai p p a dx a ng g a lx 
unnoodxa	u n n oo dx a 
panxnxala	p a nx nx a l a 
seernddeukurxeen	c ee r nd d eu k u rx ee n 
mitxtxaay	m i tx tx aa y 
ndadxai	nd a dx ai 
eerxuwaan	ee rx u w aa n 
orxrxumaiyee	o rx rx u m ai y ee 
irxaiwaneukkee	i rx ai w a n eu k k ee 
pooraatxtxattirxkeu	p oo r aa tx tx a t t i rx k eu 
unggalxeukkeuk	u ng g a lx eu k k eu k 
keetxtxeu	k ee tx tx eu 
ena	e n a 
warac	w a r a c 
palxlxikkeup	p a lx lx i k k u p 
atiga	a t i g a 
ndanrxiyootxeu	nd a n rx i y oo tx eu 
arici	a r i c i 
spoortxs	s p oo r tx s 
janamee	j a n a m ee 
mannarai	m a n n a r ai 
sirxuwar	c i rx u w a r 
maleeriyaa	m a l ee r i y aa 
pazhakkam	p a zh a k k a m 
ettanai	e t t a n ai 
kanxdxanggalxaiyum	k a nx dx a ng g a lx ai y u m 
weenxum	w ee nx u m 
wai	w ai 
ekcacais	e k c a c ai s 
peecinaar	p ee c i n aa r 
raajaa	r aa j aa 
toonrxiya	t oo n rx i y a 
iratxtxai	i r a tx tx ai 
siwil	c i w i l 
ideu	i d eu 
kadaandaayaganaaga	k a d aa nd aa y a g a n aa g a 
picaa	p i c aa 
aracareukkeu	a r a c a r eu k k eu 
seybawargalx	c e y b a w a r g a lx 
suurxaawalxip	c uu rx aa w a lx i p 
tiiwira	t ii w i r a 
puucaiyaa	p uu c ai y aa 
unxawinrxi	u nx a w i n rx i 
wenggaayam	w e ng g aa y a m 
tareen	t a r ee n 
pitxikkaada	p i tx i k k aa d a 
panjcaayatteu	p a nj c aa y a t t eu 
parxanddadeu	p a rx a nd d a d eu 
ndaanxam	nd aa nx a m 
jagam	j a g a m 
porxuppeu	p o rx u p p eu 
ruubaayin	r uu b aa y i n 
migundda	m i g u nd d a 
seyarxkaikkoolx	c e y a rx k ai k k oo lx 
perxum	p e rx u m 
manamodxinddeu	m a n a m o dx i nd d eu 
karektx	k a r e k tx 
sirxanddadeu	c i rx a nd d a d eu 
ndunggeu	nd u ng g eu 
tanggam	t a ng g a m 
uruppadxaadeu	u r u p p a dx aa d eu 
ootxtxeukkeu	oo tx tx eu k k eu 
kalwiyai	k a l w i y ai 
tanxnxiir	t a nx nx ii r 
puromoosxan	p u r o m oo sx a n 
anjcaliyum	a nj c a l i y u m 
iyarxkai	i y a rx k ai 
saappidxarxateukkeu	c aa p p i dx a rx a t eu k k eu 
uyaramaanadeu	u y a r a m aa n a d eu 
karxrxeut	k a rx rx u t 
siiragam	c ii r a g a m 
praitx	p r ai tx 
hiiroo	h ii r oo 
wanddaal	w a nd d aa l 
madippeu	m a d i p p eu 
sarinddeu	c a r i nd d eu 
todxarnddeen	t o dx a r nd d ee n 
unxmaiyil	u nx m ai y i l 
iwwizhaawaiyotxtxi	i w w i zh aa w ai y o tx tx i 
seluttinaar	c e l u t t i n aa r 
talai	t a l ai 
poorxoom	p oo rx oo m 
welxindaatxtxuc	w e lx i nd aa tx tx u c 
suwatxeu	c u w a tx eu 
keaadxuppadarxkaaga	k e aa dx u p p a d a rx k aa g a 
welxlxaik	w e lx lx ai k 
uzhaiyunggalx	u zh ai y u ng g a lx 
warugirxadeu	w a r u g i rx a d eu 
seydaar	c e y d aa r 
ulxlxana	u lx lx a n a 
floorla	f l oo r l a 
akkaraip	a k k a r ai p 
paarttaal	p aa r t t aa l 
waayppulxlxadaaga	w aa y p p u lx lx a d aa g a 
perxrxawai	p e rx rx a w ai 
owworeu	o w w o r eu 
adigaarappuuaawa	a d i g aa r a p p uu aa w a 
dxaaktxara	dx aa k tx a r a 
poogumpoodeu	p oo g u m p oo d eu 
togudi	t o g u d i 
selutteu	c e l u t t eu 
taagam	t aa g a m 
ndampikkai	nd a m p i k k ai 
oowiyar	oo w i y a r 
kanxdxupidxikkap	k a nx dx u p i dx i k k a p 
saappidxalaamaa	c aa p p i dx a l aa m aa 
ranning	r a n n i ng 
waccireukkaangga	w a c c i r eu k k aa ng g a 
irubatti	i r u b a t t i 
keetxpadeu	k ee tx p a d eu 
puujai	p uu j ai 
kalwiyee	k a l w i y ee 
payanadxaiginrxanar	p a y a n a dx ai g i n rx a n a r 
inddiyaciina	i nd d i y a c ii n a 
keetxka	k ee tx k a 
tiruppeu	t i r u p p eu 
aarwam	aa r w a m 
maruttuwamanaikkeu	m a r u t t u w a m a n ai k k eu 
wicaarikkinrxanar	w i c aa r i k k i n rx a n a r 
ndadxakkirxawargalxai	nd a dx a k k i rx a w a r g a lx ai 
ettana	e t t a n a 
maiyanggalx	m ai y a ng g a lx 
sugaadaaram	c u g aa d aa r a m 
kasxaayam	k a sx aa y a m 
konxdxadeu	k o nx dx a d eu 
ezhudiyulxlxaar	e zh u d i y u lx lx aa r 
txyuun	tx y uu n 
help	h e l p 
peydadeu	p e y d a d eu 
welxiccattirxkeu	w e lx i c c a t t i rx k eu 
satxtxanggalxaiyum	c a tx tx a ng g a lx ai y u m 
pugaippadxanggalxil	p u g ai p p a dx a ng g a lx i l 
katxcikkum	k a tx c i k k u m 
ndatxatta	nd a tx a t t a 
tamizh	t a m i zh 
erinddadeu	e r i nd d a d eu 
oreu	o r eu 
pinbeu	p i n b eu 
katxtxanxaminrxi	k a tx tx a nx a m i n rx i 
dxaaktxaraana	dx aa k tx a r aa n a 
kannadxam	k a n n a dx a m 
ndadxaimurxaigalx	nd a dx ai m u rx ai g a lx 
konxdxa	k o nx dx a 
ndallaa	nd a l l aa 
taangga	t aa ng g a 
poola	p oo l a 
ndeeratteukkeu	nd ee r a t t eu k k eu 
awarxrxulx	a w a rx rx u lx 
ireukkac	i r eu k k a c 
anddap	a nd d a p 
aatxtxattil	aa tx tx a t t i l 
iduwarai	i d u w a r ai 
adeep	a d ee p 
pingk	p i ng k 
enrxeu	e n rx eu 
pazhakkanggalxaaginrxana	p a zh a k k a ng g a lx aa g i n rx a n a 
ndinaiweu	nd i n ai w eu 
talaimaiyil	t a l ai m ai y i l 
tanittuwamaana	t a n i t t u w a m aa n a 
samaalxikka	c a m aa lx i k k a 
ndiikkappadxa	nd ii k k a p p a dx a 
pinwarumaarxeu	p i n w a r u m aa rx eu 
teerdal	t ee r d a l 
ammaawa	a m m aa w a 
fangsxanla	f a ng sx a n l a 
waay	w aa y 
siwappeu	c i w a p p eu 
senrxa	c e n rx a 
witxtxiirgalxaa	w i tx tx ii r g a lx aa 
iwarai	i w a r ai 
wizhunddadil	w i zh u nd d a d i l 
aptxeetx	a p tx ee tx 
ootxtxap	oo tx tx a p 
witxuttulxlxa	w i tx u t t u lx lx a 
kiirai	k ii r ai 
ndaatxtxil	nd aa tx tx i l 
unxarwin	u nx a r w i n 
konxdxadai	k o nx dx a d ai 
ulxlxee	u lx lx ee 
etxutteukkitxtxeen	e tx u t t eu k k i tx tx ee n 
panggeerxpadarxkaaga	p a ng g ee rx p a d a rx k aa g a 
kanxdxupitxikka	k a nx dx u p i tx i k k a 
togutteu	t o g u t t eu 
ndeeramillai	nd ee r a m i l l ai 
teewaippadxuwoor	t ee w ai p p a dx u w oo r 
inddiyaawin	i nd d i y aa w i n 
pootxtxaangga	p oo tx tx aa ng g a 
tiirweu	t ii r w eu 
urxinjci	u rx i nj c i 
suuranxam	c uu r a nx a m 
pullum	p u l l u m 
ganxeecanait	g a nx ee c a n ai t 
tanxtxitteu	t a nx tx i t t eu 
anrxeu	a n rx eu 
eedaawadoreu	ee d aa w a d o r eu 
sarkkarai	c a r k k a r ai 
kalluuriyilee	k a l l uu r i y i l ee 
ireukkaa	i r eu k k aa 
wanddaa	w a nd d aa 
jaati	j aa t i 
anxnxaa	a nx nx aa 
manamee	m a n a m ee 
sarxrxeu	c a rx rx eu 
anjcaligalx	a nj c a l i g a lx 
kanxaiyattinaal	k a nx ai y a t t i n aa l 
inculin	i n c u l i n 
wetxtxik	w e tx tx i k 
wizhaawai	w i zh aa w ai 
welxiyitxtxeu	w e lx i y i tx tx eu 
uyarnddadeu	u y a r nd d a d eu 
enrxaan	e n rx aa n 
irunddadeu	i r u nd d a d eu 
wiwaram	w i w a r a m 
aanaa	aa n aa 
keetxkat	k ee tx k a t 
ponggaleukkeu	p o ng g a l eu k k eu 
kuudxudalaaga	k uu dx u d a l aa g a 
awar	a w a r 
anumadikkappatxtxulxlxanar	a n u m a d i k k a p p a tx tx u lx lx a n a r 
waanggi	w aa ng g i 
gaanddi	g aa nd d i 
seyaleukkeut	c e y a l eu k k u t 
tayaar	t a y aa r 
abaayanggalx	a b aa y a ng g a lx 
enxkanxitattil	e nx k a nx i t a t t i l 
ida	i d a 
talaikkeu	t a l ai k k eu 
eepral	ee p r a l 
aarjidam	aa r j i d a m 
werxiccootxi	w e rx i c c oo tx i 
kuutxtxikkolxgirxadeu	k uu tx tx i k k o lx g i rx a d eu 
tarum	t a r u m 
maarxrxattaal	m aa rx rx a t t aa l 
pirxa	p i rx a 
parxippeu	p a rx i p p eu 
em	e m 
parappappatxtxateu	p a r a p p a p p a tx tx a t eu 
panxrxiinggalxaa	p a nx rx ii ng g a lx aa 
appurxamaa	a p p u rx a m aa 
sariyaa	c a r i y aa 
malar	m a l a r 
suuniyam	c uu n i y a m 
tinbateu	t i n b a t eu 
paruppugalxai	p a r u p p u g a lx ai 
inggeu	i ng g eu 
paacana	p aa c a n a 
panddaya	p a nd d a y a 
tadxawi	t a dx a w i 
ndaadxinaar	nd aa dx i n aa r 
sirxappamcanggalx	c i rx a p p a m c a ng g a lx 
saagupadxi	c aa g u p a dx i 
hootxdxaleukkeu	h oo tx dx a l eu k k eu 
illaiyadxi	i l l ai y a dx i 
lajjai	l a j j ai 
ndil	nd i l 
uuham	uu h a m 
wanddaar	w a nd d aa r 
kuuwum	k uu w u m 
kadxawulxai	k a dx a w u lx ai 
yaaraawadeu	y aa r aa w a d eu 
samuugattinaraiyum	c a m uu g a t t i n a r ai y u m 
porutxkalx	p o r u tx k a lx 
aapatteu	aa p a t t eu 
paarkka	p aa r k k a 
idan	i d a n 
txrai	tx r ai 
tirumbawum	t i r u m b a w u m 
sisxyan	c i sx y a n 
sanddoosxamaaga	c a nd d oo sx a m aa g a 
kanjci	k a nj c i 
oodxi	oo dx i 
ndilaiya	nd i l ai y a 
kurxainddeukonxdxee	k u rx ai nd d eu k o nx dx ee 
sonnadaiyee	c o n n a d ai y ee 
peecuwadeu	p ee c u w a d eu 
badil	b a d i l 
sanggattil	c a ng g a t t i l 
toolxaippitxitteu	t oo lx ai p p i tx i t t eu 
kambeu	k a m b eu 
ammaa	a m m aa 
saappitxtxaa	c aa p p i tx tx aa 
ireukkaangga	i r eu k k aa ng g a 
wacadiyaa	w a c a d i y aa 
katxtxaadee	k a tx tx aa d ee 
kasxtxam	k a sx tx a m 
eewuganxai	ee w u g a nx ai 
deecatteu	d ee c a t t eu 
illai	i l l ai 
muyarxciceygirxaargalx	m u y a rx c i c e y g i rx aa r g a lx 
pooraatxtxa	p oo r aa tx tx a 
iitxupatxtxanar	ii tx u p a tx tx a n a r 
sikiccaigalxin	c i k i c c ai g a lx i n 
tawir	t a w i r 
teejas	t ee j a s 
aarxrxin	aa rx rx i n 
seyyalaam	c e y y a l aa m 
teerdalil	t ee r d a l i l 
kadxamaiyil	k a dx a m ai y i l 
sanddikka	c a nd d i k k a 
aracaangga	a r a c aa ng g a 
appadxi	a p p a dx i 
sirxappaaga	c i rx a p p aa g a 
poorxrxi	p oo rx rx i 
aatxciyargalx	aa tx c i y a r g a lx 
ireukkaigalxil	i r eu k k ai g a lx i l 
konxtxireukkirxadeu	k o nx tx i r eu k k i rx a d eu 
piriyaanxi	p i r i y aa nx i 
heenxtx	h ee nx tx 
sellum	c e l l u m 
seyalpadxeu	c e y a l p a dx eu 
ndirxaindda	nd i rx ai nd d a 
pusxpam	p u sx p a m 
seyyin	c e y y i n 
waaraa	w aa r aa 
ndari	nd a r i 
tangguwadarxkeu	t a ng g u w a d a rx k eu 
wella	w e l l a 
alxikkappadxum	a lx i k k a p p a dx u m 
meukkiya	m eu k k i y a 
teewaiyaana	t ee w ai y aa n a 
jalcakti	j a l c a k t i 
marunddeu	m a r u nd d eu 
restx	r e s tx 
wanxanggeu	w a nx a ng g eu 
lanjca	l a nj c a 
kaanjcipuram	k aa nj c i p u r a m 
kattirikkaay	k a t t i r i k k aa y 
ezheu	e zh eu 
ireukkum	i r eu k k u m 
konxdxeen	k o nx dx ee n 
iccambawattil	i c c a m b a w a t t i l 
uriya	u r i y a 
kuurxinaar	k uu rx i n aa r 
awwalxaweu	a w w a lx a w eu 
moocamaaga	m oo c a m aa g a 
itxli	i tx l i 
mayakkam	m a y a k k a m 
teriyumaa	t e r i y u m aa 
wiitxtxila	w ii tx tx i l a 
panxnxireukkaangga	p a nx nx i r eu k k aa ng g a 
kaappiyaanadeu	k aa p p i y aa n a d eu 
yuuniyan	y uu n i y a n 
samayattil	c a m a y a t t i l 
parxrxaakkurxai	p a rx rx aa k k u rx ai 
waariyatteukkaana	w aa r i y a t t eu k k aa n a 
urxcaagamaaga	u rx c aa g a m aa g a 
maarc	m aa r c 
anuppa	a n u p p a 
kari	k a r i 
kolxlxaadee	k o lx lx aa d ee 
patxtxeu	p a tx tx eu 
udxaiyaar	u dx ai y aa r 
andndiyac	a nd nd i y a c 
amaikkappadxum	a m ai k k a p p a dx u m 
weenxdxaam	w ee nx dx aa m 
keelxwigalxai	k ee lx w i g a lx ai 
awarait	a w a r ai t 
elxiya	e lx i y a 
patxjetx	p a tx j e tx 
sinnadaa	c i n n a d aa 
ezhudanxum	e zh u d a nx u m 
tozhilil	t o zh i l i l 
illaadawan	i l l aa d a w a n 
aarxrxil	aa rx rx i l 
idil	i d i l 
kaayam	k aa y a m 
pinparxrxa	p i n p a rx rx a 
kurxitteuk	k u rx i t t eu k 
mozhi	m o zh i 
pori	p o r i 
ndagaranggalx	nd a g a r a ng g a lx 
waraweerxpai	w a r a w ee rx p ai 
peyar	p e y a r 
suzharxrxeu	c u zh a rx rx eu 
padxutteu	p a dx u t t eu 
marunddai	m a r u nd d ai 
ndaalx	nd aa lx 
irunddeu	i r u nd d eu 
appagudiyil	a p p a g u d i y i l 
ulxlxadaagawum	u lx lx a d aa g a w u m 
taawarattin	t aa w a r a t t i n 
talaigalx	t a l ai g a lx 
wazhimurxaigalxai	w a zh i m u rx ai g a lx ai 
wazhanggappatxtxadeu	w a zh a ng g a p p a tx tx a d eu 
angga	a ng g a 
kodxeu	k o dx eu 
panxamaa	p a nx a m aa 
waangga	w aa ng g a 
talxlxip	t a lx lx i p 
irundduccaa	i r u nd d u c c aa 
muulxai	m uu lx ai 
todxanggiyadeu	t o dx a ng g i y a d eu 
wazhipaatxtxinpoodeu	w a zh i p aa tx tx i n p oo d eu 
adanaal	a d a n aa l 
kadaiyaay	k a d ai y aa y 
erikkappatxtxana	e r i k k a p p a tx tx a n a 
ndadxatti	nd a dx a t t i 
tayaarikka	t a y aa r i k k a 
aacceu	aa c c eu 
acuran	a c u r a n 
erxinddadeu	e rx i nd d a d eu 
sanddai	c a nd d ai 
ulagak	u l a g a k 
pooraatxtxattil	p oo r aa tx tx a t t i l 
etirppatxugirxaargalx	e t i r p p a tx u g i rx aa r g a lx 
iruppadaiyee	i r u p p a d ai y ee 
aagum	aa g u m 
selutta	c e l u t t a 
mutalwareukkeu	m u t a l w a r eu k k eu 
makkalxum	m a k k a lx u m 
samaikkirxaangga	c a m ai k k i rx aa ng g a 
sariyaayidxum	c a r i y aa y i dx u m 
sais	c ai s 
maatxc	m aa tx c 
majjai	m a j j ai 
oruwan	o r u w a n 
amaiccar	a m ai c c a r 
idanaal	i d a n aa l 
pookka	p oo k k a 
seywaan	c e y w aa n 
miirxinaal	m ii rx i n aa l 
selwam	c e l w a m 
minnuwadeu	m i n n u w a d eu 
sonnaar	c o n n aa r 
tawarxaaga	t a w a rx aa g a 
murxitteuk	m u rx i t t eu k 
awalx	a w a lx 
poonaar	p oo n aa r 
purofasxan	p u r o f a sx a n 
atxaiyaalxamaagawum	a tx ai y aa lx a m aa g a w u m 
poodxa	p oo dx a 
meejai	m ee j ai 
nduraiyiiral	nd u r ai y ii r a l 
perunddiraalxaana	p e r u nd d i r aa lx aa n a 
porxeu	p o rx eu 
seyal	c e y a l 
weenxdxiyireukkirxadeu	w ee nx dx i y i r eu k k i rx a d eu 
ulaga	u l a g a 
peeranxiyil	p ee r a nx i y i l 
katxtxuppaadxeu	k a tx tx u p p aa dx eu 
koowaa	k oo w aa 
pakutigalx	p a k u t i g a lx 
teenggiyadeu	t ee ng g i y a d eu 
pal	p a l 
kaanxeu	k aa nx eu 
panjjaanggam	p a nj j aa ng g a m 
anbee	a n b ee 
wanddadeu	w a nd d a d eu 
sirxuwargalx	c i rx u w a r g a lx 
enxnxai	e nx nx ai 
warum	w a r u m 
palxlxi	p a lx lx i 
konxdxulxlxanar	k o nx dx u lx lx a n a r 
idxamperxrxulxlxadeu	i dx a m p e rx rx u lx lx a d eu 
wilxaiyaatxtxumeeyanrxi	w i lx ai y aa tx tx u m ee y a n rx i 
partdxee	p a r t dx ee 
wiidi	w ii d i 
kaigalxai	k ai g a lx ai 
igazhcci	i g a zh c c i 
waruginrxanar	w a r u g i n rx a n a r 
saanrxeu	c aa n rx eu 
panxnxalaam	p a nx nx a l aa m 
tanddadeu	t a nd d a d eu 
sollittarrxeen	c o l l i t t a r rx ee n 
palam	p a l a m 
penx	p e nx 
idaik	i d ai k 
eerxpatxtxadaaga	ee rx p a tx tx a d aa g a 
awai	a w ai 
maawatxtxa	m aa w a tx tx a 
alxaweu	a lx a w eu 
ndaanee	nd aa n ee 
teppam	t e p p a m 
manxal	m a nx a l 
tirumba	t i r u m b a 
aarampiccidxum	aa r a m p i c c i dx u m 
widxiyum	w i dx i y u m 
kanxidam	k a nx i d a m 
kidxaikkum	k i dx ai k k u m 
makkalxai	m a k k a lx ai 
kiizh	k ii zh 
ilakkugalxai	i l a k k u g a lx ai 
inddappaadaiyil	i nd d a p p aa d ai y i l 
ndamakkeu	nd a m a k k eu 
keeli	k ee l i 
iwaradeu	i w a r a d eu 
sariyaayidxumneu	c a r i y aa y i dx u m n eu 
reesla	r ee s l a 
dxeela	dx ee l a 
poodxuwaangga	p oo dx u w aa ng g a 
kiizhoor	k ii zh oo r 
pirabala	p i r a b a l a 
ndiyaayamaanawaidaan	nd i y aa y a m aa n a w ai d aa n 
idupoola	i d u p oo l a 
udawi	u d a w i 
unggalxudxaiya	u ng g a lx u dx ai y a 
kamalahaacan	k a m a l a h aa c a n 
marxrxoreu	m a rx rx o r eu 
keelxwiyaik	k ee lx w i y ai k 
weenxdxaamaa	w ee nx dx aa m aa 
sariyilla	c a r i y i l l a 
sollungga	c o l l u ng g a 
kulxiccutxtxeu	k u lx i c c u tx tx eu 
eerxrxam	ee rx rx a m 
raagam	r aa g a m 
wallawaneukkeup	w a l l a w a n eu k k u p 
pacittaalum	p a c i t t aa l u m 
puunai	p uu n ai 
eerxrxumadi	ee rx rx u m a d i 
adxipanxiya	a dx i p a nx i y a 
awaraik	a w a r ai k 
meyin	m e y i n 
porulxkalx	p o r u lx k a lx 
sikiccaikkeu	c i k i c c ai k k eu 
arxiwiyaleukkeu	a rx i w i y a l eu k k eu 
udxanpaatxtxirxkeu	u dx a n p aa tx tx i rx k eu 
wiruteu	w i r u t eu 
wiikkili	w ii k k i l i 
saakleetx	c aa k l ee tx 
ndam	nd a m 
peerundteu	p ee r u nd t eu 
ireukkaan	i r eu k k aa n 
awacara	a w a c a r a 
tutxippaana	t u tx i p p aa n a 
maatattirxkeu	m aa t a t t i rx k eu 
ndanrxaaka	nd a n rx aa k a 
kaattireukkeen	k aa t t i r eu k k ee n 
awaroodxa	a w a r oo dx a 
seytitxeuka	c e y t i tx eu k a 
oor	oo r 
saanrxitazhum	c aa n rx i t a zh u m 
todxarbaaga	t o dx a r b aa g a 
sariyaanateu	c a r i y aa n a t eu 
waliyateu	w a l i y a t eu 
ireu	i r eu 
paarttireukkirxeen	p aa r t t i r eu k k i rx ee n 
munpaaka	m u n p aa k a 
ndiikki	nd ii k k i 
marxrxum	m a rx rx u m 
wicaaranxai	w i c aa r a nx ai 
sellawillai	c e l l a w i l l ai 
soociyal	c oo c i y a l 
itarxkaana	i t a rx k aa n a 
paarkkaatee	p aa r k k aa t ee 
taraataram	t a r aa t a r a m 
kidxakkum	k i dx a k k u m 
talaiyil	t a l ai y i l 
wiraindteu	w i r ai nd t eu 
seywateu	c e y w a t eu 
kurxippidxappatxeukirxateu	k u rx i p p i dx a p p a tx eu k i rx a t eu 
aangkilam	aa ng k i l a m 
mundtaiya	m u nd t ai y a 
pootxtxeut	p oo tx tx u t 
parxrxiyateu	p a rx rx i y a t eu 
wacitteu	w a c i t t eu 
malxikaikkatxai	m a lx i k ai k k a tx ai 
skeen	s k ee n 
pitxiccireukkeu	p i tx i c c i r eu k k eu 
ndampar	nd a m p a r 
uur	uu r 
pakkam	p a k k a m 
tara	t a r a 
talaindakaram	t a l ai nd a k a r a m 
peetx	p ee tx 
itarxkeu	i t a rx k eu 
warrxeen	w a r rx ee n 
muyarxciyai	m u y a rx c i y ai 
paricootanai	p a r i c oo t a n ai 
tiirweukkaana	t ii r w eu k k aa n a 
yaareukkum	y aa r eu k k u m 
tueukkik	t ueu k k i k 
fiiwar	f ii w a r 
eksaam	e k s aa m 
aarampikkuteu	aa r a m p i k k u t eu 
kalyaanxam	k a l y aa nx a m 
amaanusxiyam	a m aa n u sx i y a m 
ndaaleu	nd aa l eu 
aracan	a r a c a n 
seewai	c ee w ai 
kaanxappatxeukinrxana	k aa nx a p p a tx eu k i n rx a n a 
waariyaana	w aa r i y aa n a 
penxkalxeukkeu	p e nx k a lx eu k k eu 
ndampa	nd a m p a 
kazhuwiya	k a zh u w i y a 
kinxdxal	k i nx dx a l 
kuuwalil	k uu w a l i l 
suuriyan	c uu r i y a n 
murxpakal	m u rx p a k a l 
aatxaiyil	aa tx ai y i l 
pannaatxtxalxawilum	p a n n aa tx tx a lx a w i l u m 
titxiir	t i tx ii r 
paarungkalx	p aa r u ng k a lx 
kuutxaateu	k uu tx aa t eu 
kotxeukkappatxtxateu	k o tx eu k k a p p a tx tx a t eu 
kalaaccaara	k a l aa c c aa r a 
amutamum	a m u t a m u m 
ndilaiyil	nd i l ai y i l 
aayweu	aa y w eu 
kaalattilum	k aa l a t t i l u m 
etiraana	e t i r aa n a 
kuutxiyawaiyaa	k uu tx i y a w ai y aa 
txeestxaa	tx ee s tx aa 
pootxtxaareu	p oo tx tx aa r eu 
peer	p ee r 
petxtxiyai	p e tx tx i y ai 
marxati	m a rx a t i 
mariyaatai	m a r i y aa t ai 
mandtirap	m a nd t i r a p 
aacaippatxtxaar	aa c ai p p a tx tx aa r 
inspireesxan	i n s p i r ee sx a n 
awarai	a w a r ai 
appatxit	a p p a tx i t 
um	u m 
jeyandti	j e y a nd t i 
wilxaiyum	w i lx ai y u m 
patxuwaan	p a tx u w aa n 
sirxappittanar	c i rx a p p i t t a n a r 
kuzhandtai	k u zh a nd t ai 
amaiccarawai	a m ai c c a r a w ai 
eetxtxalxawil	ee tx tx a lx a w i l 
pirateecattirxkeu	p i r a t ee c a t t i rx k eu 
ndirxaiweerxrxappatxtxa	nd i rx ai w ee rx rx a p p a tx tx a 
talaiwarkalx	t a l ai w a r k a lx 
tuutai	t uu t ai 
saappitxtxeen	c aa p p i tx tx ee n 
pirippar	p i r i p p a r 
waraikkum	w a r ai k k u m 
makizhcciyaakap	m a k i zh c c i y aa k a p 
itupoonrxa	i t u p oo n rx a 
seytikkurxippeu	c e y t i k k u rx i p p eu 
awarxrxil	a w a rx rx i l 
keaatxutteu	k e aa tx u t t eu 
inippeu	i n i p p eu 
dxaaktxar	dx aa k tx a r 
amaraatee	a m a r aa t ee 
engkalx	e ng k a lx 
wisxam	w i sx a m 
konxtxirundtaan	k o nx tx i r u nd t aa n 
wakittawar	w a k i t t a w a r 
toolwikkeu	t oo l w i k k eu 
kiraama	k i r aa m a 
ulxiyin	u lx i y i n 
ippakutikalxil	i p p a k u t i k a lx i l 
waruwa	w a r u w a 
puwaneesxwar	p u w a n ee sx w a r 
punitam	p u n i t a m 
awarutxaiya	a w a r u tx ai y a 
kolxlxawum	k o lx lx a w u m 
suwarkkangkalxil	c u w a r k k a ng k a lx i l 
mikapperiya	m i k a p p e r i y a 
eerxpatxuttiya	ee rx p a tx u t t i y a 
payanpatxutta	p a y a n p a tx u t t a 
ndirxuwanangkalx	nd i rx u w a n a ng k a lx 
patiwaakiyulxlxateu	p a t i w aa k i y u lx lx a t eu 
appaa	a p p aa 
siltxrans	c i l tx r a n s 
janawari	j a n a w a r i 
kolx	k o lx 
purxaa	p u rx aa 
tawam	t a w a m 
oruwakai	o r u w a k ai 
tatxai	t a tx ai 
paarwai	p aa r w ai 
paakka	p aa k k a 
kaalellaam	k aa l e l l aa m 
keek	k ee k 
kiriidxam	k i r ii dx a m 
katai	k a t ai 
seyya	c e y y a 
teerweu	t ee r w eu 
kanxeesxkuriyil	k a nx ee sx k u r i y i l 
porundaik	p o r u nd ai k 
wiinxum	w ii nx u m 
ndiyueu	nd i y ueu 
tuuteu	t uu t eu 
kunxamatxaindteu	k u nx a m a tx ai nd t eu 
patawiyil	p a t a w i y i l 
surxrxulaa	c u rx rx u l aa 
waayppeukalx	w aa y p p eu k a lx 
perxrxulxlxana	p e rx rx u lx lx a n a 
taippuucat	t ai p p uu c a t 
tuunxtxeukirxateu	t uu nx tx eu k i rx a t eu 
seytiyinaal	c e y t i y i n aa l 
txaark	tx aa r k 
atiracam	a t i r a c a m 
kaalai	k aa l ai 
eelakkaay	ee l a k k aa y 
etxutteu	e tx u t t eu 
maruttuwa	m a r u t t u w a 
kalandturaiyaatxiyireukkirxaar	k a l a nd t u r ai y aa tx i y i r eu k k i rx aa r 
pattirikkaiyaalxarkalxidxam	p a t t i r i k k ai y aa lx a r k a lx i dx a m 
seyyappatxtxulxlxateu	c e y y a p p a tx tx u lx lx a t eu 
mikka	m i k k a 
pakkattil	p a k k a t t i l 
sariyillaiyaa	c a r i y i l l ai y aa 
utxkaareu	u tx k aa r eu 
suuzhal	c uu zh a l 
kaasxmiir	k aa sx m ii r 
appaal	a p p aa l 
karxai	k a rx ai 
urxcawattai	u rx c a w a t t ai 
jaakkirataiyaaka	j aa k k i r a t ai y aa k a 
irundtatai	i r u nd t a t ai 
suuppuwateu	c uu p p u w a t eu 
kuwakaatti	k u w a k aa t t i 
warai	w a r ai 
innikkeu	i n n i k k eu 
kariim	k a r ii m 
winaatxikalxeukkum	w i n aa tx i k a lx eu k k u m 
pirxakeu	p i rx a k eu 
katxtxitxtxeen	k a tx tx i tx tx ee n 
warumpooteu	w a r u m p oo t eu 
paatruum	p aa t r uu m 
kuurxeu	k uu rx eu 
inikkum	i n i k k u m 
kanxini	k a nx i n i 
atxuppil	a tx u p p i l 
ndiingkalx	nd ii ng k a lx 
meukappuppakkattil	m eu k a p p u p p a k k a t t i l 
wairalaaki	w ai r a l aa k i 
ilxaiyaraajaa	i lx ai y a r aa j aa 
maanaamaturai	m aa n aa m a t u r ai 
katteukkotxeukkirxatutaan	k a t t eu k k o tx eu k k i rx a t u t aa n 
panxnxitxtxeen	p a nx nx i tx tx ee n 
irundtaan	i r u nd t aa n 
suutxaamanxi	c uu tx aa m a nx i 
tatxaakam	t a tx aa k a m 
waazhwee	w aa zh w ee 
panxam	p a nx a m 
andta	a nd t a 
maruttuwarkalxee	m a r u t t u w a r k a lx ee 
wanxangkupawarkalx	w a nx a ng k u p a w a r k a lx 
etxeukka	e tx eu k k a 
ruum	r uu m 
eppozhutum	e p p o zh u t u m 
taay	t aa y 
kaarxrxulxlxa	k aa rx rx u lx lx a 
kacakkik	k a c a k k i k 
paateukaakkappadxa	p aa t eu k aa k k a p p a dx a 
pakutiyil	p a k u t i y i l 
ndadxandtupookirxaar	nd a dx a nd t u p oo k i rx aa r 
katxtxurai	k a tx tx u r ai 
patxikka	p a tx i k k a 
warawillai	w a r a w i l l ai 
wilxaiyaatxinar	w i lx ai y aa tx i n a r 
emateu	e m a t eu 
ireukkaangkalxaa	i r eu k k aa ng k a lx aa 
paareu	p aa r eu 
puurwa	p uu r w a 
eendtinaan	ee nd t i n aa n 
kanx	k a nx 
ueukkamee	ueu k k a m ee 
iraanxuwa	i r aa nx u w a 
tirumpinar	t i r u m p i n a r 
ndaangkalxum	nd aa ng k a lx u m 
stxaar	s tx aa r 
seyyappatxtxa	c e y y a p p a tx tx a 
ndampeukirxeeaam	nd a m p eu k i rx ee aa m 
muppatti	m u p p a t t i 
otxtxeuk	o tx tx eu k 
iiyam	ii y a m 
ndaakam	nd aa k a m 
uurwateu	uu r w a t eu 
tiiraakkoopam	t ii r aa k k oo p a m 
payanpatxuttakinrxanar	p a y a n p a tx u t t a k i n rx a n a r 
peeccuwaarttai	p ee c c u w aa r t t ai 
panxattai	p a nx a t t ai 
kolxkinrxanar	k o lx k i n rx a n a r 
latxcattai	l a tx c a t t ai 
uyirkalxilum	u y i r k a lx i l u m 
pootxtxaaraa	p oo tx tx aa r aa 
jaalraa	j aa l r aa 
pazhangkutxi	p a zh a ng k u tx i 
ozhungkeu	o zh u ng k eu 
atilirundta	a t i l i r u nd t a 
kuuliyai	k uu l i y ai 
kuurxiyiruppataawateu	k uu rx i y i r u p p a t aa w a t eu 
enx	e nx 
inxaiyattalxa	i nx ai y a t t a lx a 
suupparaa	c uu p p a r aa 
toonrxeuka	t oo n rx eu k a 
yaatum	y aa t u m 
elximaiyaay	e lx i m ai y aa y 
sxaajakaan	sx aa j a k aa n 
suurxaawalxiyinaal	c uu rx aa w a lx i y i n aa l 
mozhikalx	m o zh i k a lx 
mattiya	m a t t i y a 
txawar	tx a w a r 
ndanniiril	nd a n n ii r i l 
etxutteukkolxlxum	e tx u t t eu k k o lx lx u m 
seerkkaikkaana	c ee r k k ai k k aa n a 
peyarkalx	p e y a r k a lx 
walikkuteu	w a l i k k u t eu 
paartteu	p aa r t t eu 
koosxam	k oo sx a m 
yaawarum	y aa w a r u m 
karuwikalx	k a r u w i k a lx 
pitxikkumaa	p i tx i k k u m aa 
sariyaana	c a r i y aa n a 
pakal	p a k a l 
izhuppateu	i zh u p p a t eu 
weenxtxumenak	w ee nx tx u m e n a k 
tinam	t i n a m 
porulxee	p o r u lx ee 
wazhikaatxtxeukirxapatxi	w a zh i k aa tx tx eu k i rx a p a tx i 
iisiyaa	ii s i y aa 
tolai	t o l ai 
surxrxeu	c u rx rx eu 
suraikkaay	c u r ai k k aa y 
muzhangkeu	m u zh a ng k eu 
sangkee	c a ng k ee 
mutalil	m u t a l i l 
ozhippeu	o zh i p p eu 
txaalareukkeu	tx aa l a r eu k k eu 
eeraalxamaana	ee r aa lx a m aa n a 
murxeukkeu	m u rx eu k k eu 
teeytteuk	t ee y t t eu k 
walxaiyam	w a lx ai y a m 
txiyaakoo	tx i y aa k oo 
patxeukolai	p a tx eu k o l ai 
laitx	l ai tx 
pakkattula	p a k k a t t u l a 
haacanam	h aa c a n a m 
pootxtxaalum	p oo tx tx aa l u m 
perxeu	p e rx eu 
awarxrxai	a w a rx rx ai 
eerxkanawee	ee rx k a n a w ee 
inrxeu	i n rx eu 
kazhuwi	k a zh u w i 
ulxlxaar	u lx lx aa r 
wipattil	w i p a t t i l 
ezheukirxateu	e zh eu k i rx a t eu 
umpulxlxaiya	u m p u lx lx ai y a 
ireukkirxaar	i r eu k k i rx aa r 
silawarxrxai	c i l a w a rx rx ai 
uuci	uu c i 
enkitxtxa	e n k i tx tx a 
pozhuteu	p o zh u t eu 
iiwateu	ii w a t eu 
yaanai	y aa n ai 
sirxiya	c i rx i y a 
irundtuwarum	i r u nd t u w a r u m 
mutal	m u t a l 
kalappadxam	k a l a p p a dx a m 
piriyaanxiyum	p i r i y aa nx i y u m 
setx	c e tx 
ainduurxeu	ai nd uu rx eu 
tunxi	t u nx i 
tariyaa	t a r i y aa 
jaalam	j aa l a m 
udxaleukkeu	u dx a l eu k k eu 
mayil	m a y i l 
tiruppallaanxtxeu	t i r u p p a l l aa nx tx eu 
kaappikkotxtxaikalxaaka	k aa p p i k k o tx tx ai k a lx aa k a 
kalandta	k a l a nd t a 
atxipanxiyawillai	a tx i p a nx i y a w i l l ai 
pookkuwaratteu	p oo k k u w a r a t t eu 
ndunxnxiir	nd u nx nx ii r 
munnitxtxeu	m u n n i tx tx eu 
patxtxiniyootxeu	p a tx tx i n i y oo tx eu 
porulxkalxai	p o r u lx k a lx ai 
uurlataan	uu r l a t aa n 
uulxaiyitxum	uu lx ai y i tx u m 
kal	k a l 
takka	t a k k a 
awarkalxeukkeu	a w a r k a lx eu k k eu 
wiwarikkirxateu	w i w a r i k k i rx a t eu 
appakutikalxil	a p p a k u t i k a lx i l 
meukilkalxum	m eu k i l k a lx u m 
puteu	p u t eu 
keetxtxeuk	k ee tx tx eu k 
porulxeukkeu	p o r u lx eu k k eu 
racikarkalxeukkeu	r a c i k a r k a lx eu k k eu 
enak	e n a k 
waazhkkai	w aa zh k k ai 
mutxiccaacceu	m u tx i c c aa c c eu 
unkitxtxa	u n k i tx tx a 
keeratx	k ee r a tx 
enrxaal	e n rx aa l 
saampal	c aa m p a l 
pool	p oo l 
raamar	r aa m a r 
sengkatir	c e ng k a t i r 
pakai	p a k ai 
sirxiteu	c i rx i t eu 
pookum	p oo k u m 
etirpaarkkinrxeen	e t i r p aa r k k i n rx ee n 
txelliyil	tx e l l i y i l 
wilaiyil	w i l ai y i l 
amara	a m a r a 
makizhcciyootxeu	m a k i zh c c i y oo tx eu 
pongkal	p o ng k a l 
kuyil	k u y i l 
iteukurxitteu	i t eu k u rx i t t eu 
kutxumpa	k u tx u m p a 
maarxrxattirxkulxlxaana	m aa rx rx a t t i rx k u lx lx aa n a 
kaayccaleukkeu	k aa y c c a l eu k k eu 
uttarawitxtxirundtateu	u t t a r a w i tx tx i r u nd t a t eu 
mutxiyaatenrxeu	m u tx i y aa t e n rx eu 
parxrxaakkurxaiyaip	p a rx rx aa k k u rx ai y ai p 
peereu	p ee r eu 
ndaangka	nd aa ng k a 
ndampaatee	nd a m p aa t ee 
samiipamaaka	c a m ii p a m aa k a 
karjikkum	k a r j i k k u m 
tuurxrxikkolx	t uu rx rx i k k o lx 
wellam	w e l l a m 
kutxuwaiyaik	k u tx u w ai y ai k 
iruppeu	i r u p p eu 
padxattirxkaana	p a dx a t t i rx k aa n a 
ndiir	nd ii r 
dxawutx	dx a w u tx 
winjnjaana	w i nj nj aa n a 
taaniyam	t aa n i y a m 
kutxiyurimai	k u tx i y u r i m ai 
keelariyai	k ee l a r i y ai 
wacuul	w a c uu l 
ezhuppinaar	e zh u p p i n aa r 
pookacceyyalaam	p oo k a c c e y y a l aa m 
wiitxtxeukkulxlxa	w ii tx tx eu k k u lx lx a 
ndaa	nd aa 
sangkamam	c a ng k a m a m 
pilxirxum	p i lx i rx u m 
atirupti	a t i r u p t i 
mikawum	m i k a w u m 
patilalxikka	p a t i l a lx i k k a 
paateukaappeu	p aa t eu k aa p p eu 
oppeukkonxtxaar	o p p eu k k o nx tx aa r 
wetxtxi	w e tx tx i 
waramilxakaay	w a r a m i lx a k aa y 
padxangkalxilum	p a dx a ng k a lx i l u m 
muteukeu	m u t eu k eu 
ennoodxa	e n n oo dx a 
sutxtxuraip	c u tx tx u r ai p 
poorxa	p oo rx a 
manam	m a n a m 
pandtai	p a nd t ai 
seyyappatxum	c e y y a p p a tx u m 
mazhaiyee	m a zh ai y ee 
todxar	t o dx a r 
nditikkeu	nd i t i k k eu 
ellaarum	e l l aa r u m 
waliyurxuttinaar	w a l i y u rx u t t i n aa r 
kaalaiyila	k aa l ai y i l a 
txres	tx r e s 
walikkum	w a l i k k u m 
suutxaa	c uu tx aa 
iiramaa	ii r a m aa 
peukai	p eu k ai 
eerikkeu	ee r i k k eu 
patxippateu	p a tx i p p a t eu 
maranxamum	m a r a nx a m u m 
wilxaiyaatxuwatillai	w i lx ai y aa tx u w a t i l l ai 
katxtxanxangkalx	k a tx tx a nx a ng k a lx 
terxkeu	t e rx k eu 
eerxpaatxeukalx	ee rx p aa tx eu k a lx 
ikazhndteu	i k a zh nd t eu 
awaree	a w a r ee 
ilxampenx	i lx a m p e nx 
kaangkiras	k aa ng k i r a s 
paampeukalx	p aa m p eu k a lx 
kurxrxawaalxi	k u rx rx a w aa lx i 
rees	r ee s 
injci	i nj c i 
taajmahaalai	t aa j m a h aa l ai 
enakkeu	e n a k k eu 
piramaanxdxa	p i r a m aa nx dx a 
roosxam	r oo sx a m 
manandilaiyaiyum	m a n a nd i l ai y ai y u m 
kaiyadxakka	k ai y a dx a k k a 
ilakkaaka	i l a k k aa k a 
samandilaiyil	c a m a nd i l ai y i l 
urimaiyaa	u r i m ai y aa 
wareukirxaar	w a r eu k i rx aa r 
tappeu	t a p p eu 
juulai	j uu l ai 
muulaiyil	m uu l ai y i l 
kaip	k ai p 
tingkalx	t i ng k a lx 
siikkirattil	c ii k k i r a t t i l 
wiirarkalxeukkaana	w ii r a r k a lx eu k k aa n a 
makarandtam	m a k a r a nd t a m 
wiceesxam	w i c ee sx a m 
sitamparam	c i t a m p a r a m 
seytaal	c e y t aa l 
seyteu	c e y t eu 
onrxum	o n rx u m 
tiipaawalxi	t ii p aa w a lx i 
ndirxaiya	nd i rx ai y a 
penxkalxidxam	p e nx k a lx i dx a m 
wipatteu	w i p a t t eu 
sindtaiyai	c i nd t ai y ai 
karxiweeppilai	k a rx i w ee p p i l ai 
kuuppitxatxtxumaa	k uu p p i tx a tx tx u m aa 
sennaiyila	c e n n ai y i l a 
idxa	i dx a 
njaalam	nj aa l a m 
pazham	p a zh a m 
iyampeu	i y a m p eu 
kadxarxkaraiyil	k a dx a rx k a r ai y i l 
andtat	a nd t a t 
potumakkalxai	p o t u m a k k a lx ai 
wiinxaakka	w ii nx aa k k a 
weedxattil	w ee dx a t t i l 
tirumpinaar	t i r u m p i n aa r 
ulxlxaatxci	u lx lx aa tx c i 
arxikkaiyaik	a rx i k k ai y ai k 
karutteu	k a r u t t eu 
wakaiyil	w a k ai y i l 
teriwittanar	t e r i w i t t a n a r 
alxitta	a lx i t t a 
muudxanum	m uu dx a n u m 
kulxiruteu	k u lx i r u t eu 
puttakam	p u t t a k a m 
endta	e nd t a 
utweekattai	u t w ee k a t t ai 
ndatxittulxlxaar	nd a tx i t t u lx lx aa r 
seyta	c e y t a 
urxangkac	u rx a ng k a c 
stxaak	s tx aa k 
aitiikam	ai t ii k a m 
aajar	aa j a r 
pakti	p a k t i 
sittiramum	c i t t i r a m u m 
kawacam	k a w a c a m 
stampittateu	s t a m p i t t a t eu 
indtiya	i nd t i y a 
irattam	i r a t t a m 
kaal	k aa l 
irundtucceu	i r u nd t u c c eu 
wilxaiyaatxtxeu	w i lx ai y aa tx tx eu 
kaayamatxaindta	k aa y a m a tx ai nd t a 
ungkalxaik	u ng k a lx ai k 
tamakkeu	t a m a k k eu 
tayaweu	t a y a w eu 
jenma	j e n m a 
toosxattirxkeu	t oo sx a t t i rx k eu 
toonxtxiyateu	t oo nx tx i y a t eu 
ootxtxai	oo tx tx ai 
ndalamalxikkum	nd a l a m a lx i k k u m 
uurudxan	uu r u dx a n 
ilawacam	i l a w a c a m 
seytaan	c e y t aa n 
sampandtamaaka	c a m p a nd t a m aa k a 
azhittitxuwoom	a zh i t t i tx u w oo m 
iwarkalx	i w a r k a lx 
wiral	w i r a l 
palweerxeu	p a l w ee rx eu 
udxampeu	u dx a m p eu 
fangsxan	f a ng sx a n 
tusxtxa	t u sx tx a 
ndatxikar	nd a tx i k a r 
aarxutal	aa rx u t a l 
ndails	nd ai l s 
kaatxtxa	k aa tx tx a 
katxtxam	k a tx tx a m 
ketxuwaan	k e tx u w aa n 
aayinum	aa y i n u m 
kulxir	k u lx i r 
mannaa	m a n n aa 
minnanxeu	m i n n a nx eu 
sandtarppacuuzhndilaikalxai	c a nd t a r p p a c uu zh nd i l ai k a lx ai 
teerwil	t ee r w i l 
panxiyai	p a nx i y ai 
wandtana	w a nd t a n a 
ndaatxaaka	nd aa tx aa k a 
wazhiyaaka	w a zh i y aa k a 
katxungkoopam	k a tx u ng k oo p a m 
puumi	p uu m i 
txicain	tx i c ai n 
paarkkumpooteu	p aa r k k u m p oo t eu 
part	p a r t 
iwarkalxait	i w a r k a lx ai t 
patxuttappatxtxawarkalxaaka	p a tx u t t a p p a tx tx a w a r k a lx aa k a 
azhiweu	a zh i w eu 
tanateu	t a n a t eu 
sirxaiyil	c i rx ai y i l 
poowaa	p oo w aa 
kiptx	k i p tx 
koowil	k oo w i l 
pooraay	p oo r aa y 
aayutam	aa y u t a m 
ilxainjan	i lx ai nj a n 
ndadxattappatxum	nd a dx a t t a p p a tx u m 
rool	r oo l 
perumalxawil	p e r u m a lx a w i l 
wiinxaakac	w ii nx aa k a c 
kooltxaa	k oo l tx aa 
kacaayam	k a c aa y a m 
poliwaaka	p o l i w aa k a 
patxtxam	p a tx tx a m 
alxandteu	a lx a nd t eu 
adxakkeu	a dx a k k eu 
ndeerattil	nd ee r a t t i l 
maatattil	m aa t a t t i l 
munpeu	m u n p eu 
tunxtxeukalxaaka	t u nx tx eu k a lx aa k a 
ndanrxi	nd a n rx i 
seytatarxkaaka	c e y t a t a rx k aa k a 
tanxnxiir	t a nx nx ii r 
peukaippadxam	p eu k ai p p a dx a m 
ootxuna	oo tx u n a 
solli	c o l l i 
unxmaikalxai	u nx m ai k a lx ai 
waanoli	w aa n o l i 
ndadxawatxikkaikalxai	nd a dx a w a tx i k k ai k a lx ai 
kandtaka	k a nd t a k a 
ndalla	nd a l l a 
amcangkalx	a m c a ng k a lx 
sarppam	c a r p p a m 
taazha	t aa zh a 
iitxupatxtxeu	ii tx u p a tx tx eu 
ewwaarxeu	e w w aa rx eu 
payanpatxuttuwatait	p a y a n p a tx u t t u w a t ai t 
paateukaappum	p aa t eu k aa p p u m 
amaitikkeu	a m ai t i k k eu 
ndirxka	nd i rx k a 
ennutxaiya	e n n u tx ai y a 
ndiikkappatxtxa	nd ii k k a p p a tx tx a 
pazhakaatee	p a zh a k aa t ee 
peukazhin	p eu k a zh i n 
njaayirxeu	nj aa y i rx eu 
siwaneukkeu	c i w a n eu k k eu 
waazhndtaal	w aa zh nd t aa l 
enna	e n n a 
muulamaaka	m uu l a m aa k a 
mattiyastam	m a t t i y a s t a m 
waitteu	w ai t t eu 
padxattai	p a dx a t t ai 
taniyaaka	t a n i y aa k a 
satxtxamanrxam	c a tx tx a m a n rx a m 
tammaal	t a m m aa l 
waangkitxtxeu	w aa ng k i tx tx eu 
ndanjceu	nd a nj c eu 
kunxam	k u nx a m 
maatulxai	m aa t u lx ai 
matxtxam	m a tx tx a m 
welxlxam	w e lx lx a m 
kuutxi	k uu tx i 
sendtamizhum	c e nd t a m i zh u m 
jakattinai	j a k a t t i n ai 
meukattil	m eu k a t t i l 
kaaceu	k aa c eu 
onrxutaan	o n rx u t aa n 
kulxirndta	k u lx i r nd t a 
udxanatxiyaana	u dx a n a tx i y aa n a 
sikiccaikkaaka	c i k i c c ai k k aa k a 
kitxaittulxlxana	k i tx ai t t u lx lx a n a 
kilxaas	k i lx aa s 
palacaali	p a l a c aa l i 
eerxpaatxeu	ee rx p aa tx eu 
konxtxeu	k o nx tx eu 
ndipunxarkalxin	nd i p u nx a r k a lx i n 
teriwikkappatxtxulxlxateu	t e r i w i k k a p p a tx tx u lx lx a t eu 
ituwee	i t u w ee 
seytireukkirxeen	c e y t i r eu k k i rx ee n 
ndatxippeu	nd a tx i p p eu 
kurxiyiitxeukalx	k u rx i y ii tx eu k a lx 
ndaatam	nd aa t a m 
kalandteukonxtxeu	k a l a nd t eu k o nx tx eu 
katiyena	k a t i y e n a 
wazhangka	w a zh a ng k a 
kalandtaayweu	k a l a nd t aa y w eu 
konxtxuwarappatxtxateu	k o nx tx u w a r a p p a tx tx a t eu 
walxarcci	w a lx a r c c i 
aktxoopar	a k tx oo p a r 
saalaiyil	c aa l ai y i l 
seyyaatee	c e y y aa t ee 
padxar	p a dx a r 
miin	m ii n 
anaiwarateu	a n ai w a r a t eu 
taaniyangki	t aa n i y a ng k i 
awwaarxeu	a w w aa rx eu 
sirxeu	c i rx eu 
witxuti	w i tx u t i 
es	e s 
talxlxum	t a lx lx u m 
panxnxiyaa	p a nx nx i y aa 
wadxa	w a dx a 
kuurndteu	k uu r nd t eu 
atxaateu	a tx aa t eu 
minkalattin	m i n k a l a t t i n 
solween	c o l w ee n 
senrxirundtaan	c e n rx i r u nd t aa n 
sati	c a t i 
kanxtxupitxippeukalxai	k a nx tx u p i tx i p p eu k a lx ai 
seyteukonxtxaan	c e y t eu k o nx tx aa n 
sinimaawil	c i n i m aa w i l 
ireukkeu	i r eu k k eu 
aancaraa	aa n c a r aa 
kaatxtxum	k aa tx tx u m 
karuttarangkam	k a r u t t a r a ng k a m 
sarxrxeup	c a rx rx u p 
takawalkalxumee	t a k a w a l k a lx u m ee 
ezhutteut	e zh u t t u t 
kaay	k aa y 
awa	a w a 
puucci	p uu c c i 
sangkeu	c a ng k eu 
taan	t aa n 
katxikkum	k a tx i k k u m 
etirolikkinrxana	e t i r o l i k k i n rx a n a 
tangkalxateu	t a ng k a lx a t eu 
sonnaalum	c o n n aa l u m 
saappitxtxiyaa	c aa p p i tx tx i y aa 
siikkaramaa	c ii k k a r a m aa 
ndooyarxrxa	nd oo y a rx rx a 
ndinaitteen	nd i n ai t t ee n 
arxiwiyal	a rx i w i y a l 
waazhkirxoom	w aa zh k i rx oo m 
wandta	w a nd t a 
ireukka	i r eu k k a 
maaruti	m aa r u t i 
waittanar	w ai t t a n a r 
appaakkeu	a p p aa k k eu 
kaatxtxeukirxaar	k aa tx tx eu k i rx aa r 
iniya	i n i y a 
kurxippitxtxa	k u rx i p p i tx tx a 
atuwum	a t u w u m 
widxamaatxtxaan	w i dx a m aa tx tx aa n 
patxtxaaceu	p a tx tx aa c eu 
muutxtxi	m uu tx tx i 
koolxkalx	k oo lx k a lx 
rampam	r a m p a m 
katxtxalxaikkeu	k a tx tx a lx ai k k eu 
seytanar	c e y t a n a r 
seyyum	c e y y u m 
angkattinaraal	a ng k a t t i n a r aa l 
keeptxan	k ee p tx a n 
hootxtxal	h oo tx tx a l 
aayitxucceu	aa y i tx u c c eu 
manjcalx	m a nj c a lx 
patxaateu	p a tx aa t eu 
warxuttum	w a rx u t t u m 
seyalpatxtxateu	c e y a l p a tx tx a t eu 
idxattileeyee	i dx a t t i l ee y ee 
ittitxtxattin	i t t i tx tx a t t i n 
eerxpatxuttappatxtxulxlxana	ee rx p a tx u t t a p p a tx tx u lx lx a n a 
kuzhandtaikalxeukkeu	k u zh a nd t ai k a lx eu k k eu 
idxattula	i dx a t t u l a 
panxnxatxtxumaa	p a nx nx a tx tx u m aa 
paappaa	p aa p p aa 
watxakkeu	w a tx a k k eu 
atxakkamee	a tx a k k a m ee 
enpateu	e n p a t eu 
muuzhkuwatupeeaal	m uu zh k u w a t u p ee aa l 
kuurxiwitxtxeen	k uu rx i w i tx tx ee n 
araciyal	a r a c i y a l 
ndilaippaatxeu	nd i l ai p p aa tx eu 
etuwum	e t u w u m 
marxuttaarkalx	m a rx u t t aa r k a lx 
toolwiyurxrxateu	t oo l w i y u rx rx a t eu 
ulxlxaatxcit	u lx lx aa tx c i t 
irunduurxeu	i r u nd uu rx eu 
piranxtxs	p i r a nx tx s 
wiitxtxil	w ii tx tx i l 
ooram	oo r a m 
witxuttireukkirxaar	w i tx u t t i r eu k k i rx aa r 
kurxippaaka	k u rx i p p aa k a 
atil	a t i l 
seyyawillai	c e y y a w i l l ai 
oocai	oo c ai 
siramamaanatalla	c i r a m a m aa n a t a l l a 
tangkac	t a ng k a c 
awar	a w a r 
tiirmaanangkalx	t ii r m aa n a ng k a lx 
munnaalx	m u n n aa lx 
potxtxal	p o tx tx a l 
poorxaangka	p oo rx aa ng k a 
njaapaka	nj aa p a k a 
suzhi	c u zh i 
teruwil	t e r u w i l 
paramparai	p a r a m p a r ai 
maatxtxeeaam	m aa tx tx ee aa m 
eerxpa	ee rx p a 
puungkaakkalxeukkeu	p uu ng k aa k k a lx eu k k eu 
wiitxiyoowaiyum	w ii tx i y oo w ai y u m 
pootxtxa	p oo tx tx a 
wanxtxi	w a nx tx i 
keetxeu	k ee tx eu 
maatxtxeukkeu	m aa tx tx eu k k eu 
patawikalxai	p a t a w i k a lx ai 
wiitxtxilum	w ii tx tx i l u m 
oruwareukkoruwar	o r u w a r eu k k o r u w a r 
talaiwirittaatxik	t a l ai w i r i t t aa tx i k 
sila	c i l a 
ndookkungkalx	nd oo k k u ng k a lx 
ndaanarxiween	nd aa n a rx i w ee n 
pizhaiyalla	p i zh ai y a l l a 
ndatxaiperxrxa	nd a tx ai p e rx rx a 
waa	w aa 
aa	a a 
eksaamkkeu	e k s aa m k k eu 
risxikkeu	r i sx i k k eu 
paanam	p aa n a m 
kurxai	k u rx ai 
katxtxumarattil	k a tx tx u m a r a t t i l 
itarxkaaka	i t a rx k aa k a 
engkeu	e ng k eu 
apisxeekam	a p i sx ee k a m 
wiirar	w ii r a r 
anuppappatxtxa	a n u p p a p p a tx tx a 
atanpooteu	a t a n p oo t eu 
txeyli	tx e y l i 
kitxtxa	k i tx tx a 
onneu	o n n eu 
pon	p o n 
puujaiyil	p uu j ai y i l 
saasxtxaangkam	c aa sx tx aa ng k a m 
seywana	c e y w a n a 
kanxnxiyap	k a nx nx i y a p 
periya	p e r i y a 
orijinal	o r i j i n a l 
iruppataal	i r u p p a t aa l 
mutxiyaateu	m u tx i y aa t eu 
aanxkalxee	aa nx k a lx ee 
katxeukeu	k a tx eu k eu 
irxaiyarulx	i rx ai y a r u lx 
tirumpiwarakkuutxumaa	t i r u m p i w a r a k k uu tx u m aa 
paadxam	p aa dx a m 
mutxiweukkeu	m u tx i w eu k k eu 
paatikkum	p aa t i k k u m 
seewalin	c ee w a l i n 
sengkamalam	c e ng k a m a l a m 
paatxtxeup	p aa tx tx u p 
uyirizhappeu	u y i r i zh a p p eu 
padxattil	p a dx a t t i l 
siiaawaricaip	c ii aa w a r i c ai p 
maandilamaaka	m aa nd i l a m aa k a 
tamizhakam	t a m i zh a k a m 
porxiyiyal	p o rx i y i y a l 
pookanxum	p oo k a nx u m 
txiras	tx i r a s 
angkeu	a ng k eu 
aastireeliya	aa s t i r ee l i y a 
tayaarittireukkirxaar	t a y aa r i t t i r eu k k i rx aa r 
tarxpooteu	t a rx p oo t eu 
rompa	r o m p a 
warxutteuk	w a rx u t t eu k 
ippoo	i p p oo 
koolxaarxeu	k oo lx aa rx eu 
njaanam	nj aa n a m 
saarxeu	c aa rx eu 
tandtai	t a nd t ai 
payam	p a y a m 
karxi	k a rx i 
minjcinaal	m i nj c i n aa l 
waazhttinaarkalx	w aa zh t t i n aa r k a lx 
waal	w aa l 
perxrxeukkolxlxalaam	p e rx rx eu k k o lx lx a l aa m 
meukkiyat	m eu k k i y a t 
ndadxakkawillai	nd a dx a k k a w i l l ai 
ndaatxtxeukkeu	nd aa tx tx eu k k eu 
sangkili	c a ng k i l i 
penxkalx	p e nx k a lx 
ireukkeen	i r eu k k ee n 
aamaa	aa m aa 
tuulx	t uu lx 
wiwacaayikalx	w i w a c aa y i k a lx 
uruwaana	u r u w aa n a 
allateu	a l l a t eu 
en	e n 
atxaindtoor	a tx ai nd t oo r 
manandilaiyaip	m a n a nd i l ai y ai p 
wiitxiyoo	w ii tx i y oo 
pirapalam	p i r a p a l a m 
kiriim	k i r ii m 
sollitxuween	c o l l i tx u w ee n 
pootxtxi	p oo tx tx i 
ilxainjaneukkeu	i lx ai nj a n eu k k eu 
teriwikkinrxana	t e r i w i k k i n rx a n a 
aatxtxam	aa tx tx a m 
satxtxa	c a tx tx a 
itaiyatxutteu	i t ai y a tx u t t eu 
atilulxlxa	a t i l u lx lx a 
teriyawillai	t e r i y a w i l l ai 
ndilawiyateu	nd i l a w i y a t eu 
weppam	w e p p a m 
adxangkiya	a dx a ng k i y a 
aatxtxattai	aa tx tx a t t ai 
iranxtxeu	i r a nx tx eu 
matxtxumtaan	m a tx tx u m t aa n 
seukkunduurxaaka	c eu k k u nd uu rx aa k a 
arxindteu	a rx i nd t eu 
kurxaiwaaka	k u rx ai w aa k a 
arxiwiirkalxeeaaa	a rx i w ii r k a lx ee aa a 
kalyaanxatteukkeu	k a l y aa nx a t t eu k k eu 
usxnxam	u sx nx a m 
aparaatam	a p a r aa t a m 
kulam	k u l a m 
keetxtxaan	k ee tx tx aa n 
patilalxippiirkalx	p a t i l a lx i p p ii r k a lx 
hoormoon	h oo r m oo n 
puttam	p u t t a m 
eerxpaatxellaam	ee rx p aa tx e l l aa m 
skuulla	s k uu l l a 
txiraskalar	tx i r a s k a l a r 
paattirattil	p aa t t i r a t t i l 
sandtaikalxeukkum	c a nd t ai k a lx eu k k u m 
ilawacamaaka	i l a w a c a m aa k a 
kanxtxaar	k a nx tx aa r 
atuwarai	a t u w a r ai 
eppozhutumee	e p p o zh u t u m ee 
alxikka	a lx i k k a 
karektxaana	k a r e k tx aa n a 
paartxtxicipeetx	p aa r tx tx i c i p ee tx 
patxikkirxeen	p a tx i k k i rx ee n 
meempaatxtxeut	m ee m p aa tx tx u t 
itaippoonrxa	i t ai p p oo n rx a 
poonrxa	p oo n rx a 
tooni	t oo n i 
meelee	m ee l ee 
katxtxi	k a tx tx i 
parikaaram	p a r i k aa r a m 
tatruupamaaka	t a t r uu p a m aa k a 
suwai	c u w ai 
ayalndaatxeukalxeukkeup	a y a l nd aa tx eu k a lx eu k k u p 
wakaikalx	w a k ai k a lx 
ndatxikkawulxlxataakawum	nd a tx i k k a w u lx lx a t aa k a w u m 
suuppar	c uu p p a r 
paraparappaaka	p a r a p a r a p p aa k a 
tanxnxii	t a nx nx ii 
tuuwi	t uu w i 
ndaay	nd aa y 
matippenx	m a t i p p e nx 
pakalawan	p a k a l a w a n 
wirxkappatxeukirxateu	w i rx k a p p a tx eu k i rx a t eu 
eerxpatxeukirxateu	ee rx p a tx eu k i rx a t eu 
wacanam	w a c a n a m 
ndatxaiperxa	nd a tx ai p e rx a 
kaatxtxamaaka	k aa tx tx a m aa k a 
waataatxinaar	w aa t aa tx i n aa r 
teeaalwi	t ee aa l w i 
pazhaniyammaalx	p a zh a n i y a m m aa lx 
tiruwizhaaweukkeu	t i r u w i zh aa w eu k k eu 
kazhicceu	k a zh i c c eu 
irungkalx	i r u ng k a lx 
jeyhindt	j e y h i nd t 
peeceu	p ee c eu 
kaalaiyil	k aa l ai y i l 
rajini	r a j i n i 
taawarangkalxil	t aa w a r a ng k a lx i l 
ireukkaateu	i r eu k k aa t eu 
seerxrxil	c ee rx rx i l 
sanxtxai	c a nx tx ai 
warala	w a r a l a 
panxnxi	p a nx nx i 
eendteu	ee nd t eu 
tanusxkootxi	t a n u sx k oo tx i 
sotteu	c o t t eu 
manxikkeu	m a nx i k k eu 
kadxakkum	k a dx a k k u m 
atxeukkatxeukkaana	a tx eu k k a tx eu k k aa n a 
eetaawateu	ee t aa w a t eu 
poolaweetaan	p oo l a w ee t aa n 
warrxaangka	w a r rx aa ng k a 
ndeeram	nd ee r a m 
maatam	m aa t a m 
tirxandteu	t i rx a nd t eu 
kotxtxuwateu	k o tx tx u w a t eu 
wicuwaacam	w i c u w aa c a m 
ndiitxikka	nd ii tx i k k a 
kidxandtaarkalx	k i dx a nd t aa r k a lx 
ingkee	i ng k ee 
orucinna	o r u c i n n a 
tinacari	t i n a c a r i 
putxiccireukkaa	p u tx i c c i r eu k k aa 
leetx	l ee tx 
mahaawiir	m a h aa w ii r 
koopuram	k oo p u r a m 
puli	p u l i 
kitxaiccaa	k i tx ai c c aa 
awarkalx	a w a r k a lx 
payanarkalx	p a y a n a r k a lx 
racikarkalx	r a c i k a r k a lx 
wazhimaarxi	w a zh i m aa rx i 
raajaawaaka	r aa j aa w aa k a 
rajinikaandteukkeu	r a j i n i k aa nd t eu k k eu 
poosxaakkaana	p oo sx aa k k aa n a 
porulx	p o r u lx 
waayndtateu	w aa y nd t a t eu 
urai	u r ai 
seyti	c e y t i 
ippa	i p p a 
sappaatti	c a p p aa t t i 
weyitx	w e y i tx 
waangkiniyaa	w aa ng k i n i y aa 
eerxi	ee rx i 
wareukai	w a r eu k ai 
kitxtxawandtaal	k i tx tx a w a nd t aa l 
akawum	a k a w u m 
karutteukkalx	k a r u t t eu k k a lx 
pirenjceu	p i r e nj c eu 
atikamaaka	a t i k a m aa k a 
munnarum	m u n n a r u m 
sindtanaikalxai	c i nd t a n ai k a lx ai 
tirumanxap	t i r u m a nx a p 
itaip	i t ai p 
muunxeu	m uu nx eu 
awangka	a w a ng k a 
pamparam	p a m p a r a m 
pirxar	p i rx a r 
tirumpiwandteu	t i r u m p i w a nd t eu 
maaceuk	m aa c eu k 
eksaameukkeu	e k s aa m eu k k eu 
win	w i n 
unxaweu	u nx a w eu 
katxtxeu	k a tx tx eu 
azhaippeu	a zh ai p p eu 
tarxkolai	t a rx k o l ai 
makan	m a k a n 
katx	k a tx 
muulatanam	m uu l a t a n a m 
elumpeu	e l u m p eu 
pinparxrxeu	p i n p a rx rx eu 
tulakka	t u l a k k a 
ndinrxeu	nd i n rx eu 
werxrxi	w e rx rx i 
itee	i t ee 
wandtaarkalx	w a nd t aa r k a lx 
anaittaiyum	a n ai t t ai y u m 
kaaramaa	k aa r a m aa 
kilxampeu	k i lx a m p eu 
puliyaip	p u l i y ai p 
ozheukkamaaka	o zh eu k k a m aa k a 
karxrxeuk	k a rx rx eu k 
alxaweeyillai	a lx a w ee y i l l ai 
seyyappatxtxulxlxana	c e y y a p p a tx tx u lx lx a n a 
wareen	w a r ee n 
ennallaam	e n n a l l aa m 
welxiyila	w e lx i y i l a 
ezhuppaatee	e zh u p p aa t ee 
paampeu	p aa m p eu 
kattiyait	k a t t i y ai t 
weenxtxiya	w ee nx tx i y a 
mutxiyaamal	m u tx i y aa m a l 
wariyaa	w a r i y aa 
awalxeukkeu	a w a lx eu k k eu 
tueukkam	t ueu k k a m 
miinawanin	m ii n a w a n i n 
kanxtxupitxikkappatxtxateu	k a nx tx u p i tx i k k a p p a tx tx a t eu 
ndaatxeukalxulx	nd aa tx eu k a lx u lx 
witxutikalx	w i tx u t i k a lx 
weenxtxiyirundtateu	w ee nx tx i y i r u nd t a t eu 
katxtxeukkaawal	k a tx tx eu k k aa w a l 
weerxillai	w ee rx i l l ai 
aaranjceu	aa r a nj c eu 
malaiyaalxa	m a l ai y aa lx a 
kawanam	k a w a n a m 
etarxkaaka	e t a rx k aa k a 
waazhtteukalx	w aa zh t t eu k a lx 
aanandtam	aa n a nd t a m 
ndii	nd ii 
aarxeu	aa rx eu 
ingka	i ng k a 
mutxtxaalx	m u tx tx aa lx 
wengkaayattaip	w e ng k aa y a t t ai p 
txaatxaa	tx aa tx aa 
marxrxapatxi	m a rx rx a p a tx i 
waakanangkalx	w aa k a n a ng k a lx 
pirxandta	p i rx a nd t a 
welxiyitxtxa	w e lx i y i tx tx a 
maatiriyaaka	m aa t i r i y aa k a 
ulakin	u l a k i n 
uyaree	u y a r ee 
ndallateu	nd a l l a t eu 
weenxumaa	w ee nx u m aa 
pangkalxaateesx	p a ng k a lx aa t ee sx 
siikkiram	c ii k k i r a m 
satxtxam	c a tx tx a m 
ndanrxum	nd a n rx u m 
taruween	t a r u w ee n 
seyyat	c e y y a t 
ulxlxa	u lx lx a 
indtiyaa	i nd t i y aa 
karuwuula	k a r u w uu l a 
wirxpanai	w i rx p a n ai 
kasxtxamum	k a sx tx a m u m 
atxippatxai	a tx i p p a tx ai 
appaayinmenxtx	a p p aa y i n m e nx tx 
panxnxanum	p a nx nx a n u m 
paampai	p aa m p ai 
saami	c aa m i 
payirxeu	p a y i rx eu 
incol	i n c o l 
andtappurattirxkuc	a nd t a p p u r a t t i rx k u c 
wilaki	w i l a k i 
waralai	w a r a l ai 
uleukkinaalx	u l eu k k i n aa lx 
iiciyaa	ii c i y aa 
kutxtxaiyil	k u tx tx ai y i l 
utxaimai	u tx ai m ai 
kazhitteuk	k a zh i t t eu k 
itanaiyatxutteu	i t a n ai y a tx u t t eu 
puunxtxeu	p uu nx tx eu 
tiiwaitteu	t ii w ai t t eu 
tozhilndutxpatturxai	t o zh i l nd u tx p a t t u rx ai 
aarampikkum	aa r a m p i k k u m 
hoom	h oo m 
marattai	m a r a t t ai 
paanxiyil	p aa nx i y i l 
atxiyaarkalx	a tx i y aa r k a lx 
kaapi	k aa p i 
awarpaal	a w a r p aa l 
winxnxappa	w i nx nx a p p a 
ndal	nd a l 
kotxeukkumaarxeu	k o tx eu k k u m aa rx eu 
kuutxtxanxiyil	k uu tx tx a nx i y i l 
wiirarkalxeukkeu	w ii r a r k a lx eu k k eu 
teeciya	t ee c i y a 
kucci	k u c c i 
panxdxam	p a nx dx a m 
kurxaiwarxrxa	k u rx ai w a rx rx a 
kawalaiyillaamal	k a w a l ai y i l l aa m a l 
atxikkatxi	a tx i k k a tx i 
tiruttam	t i r u t t a m 
awwappooteu	a w w a p p oo t eu 
anxiwakuppeu	a nx i w a k u p p eu 
meukkiyattuwam	m eu k k i y a t t u w a m 
katxumaiyaana	k a tx u m ai y aa n a 
smook	s m oo k 
pil	p i l 
aardxar	aa r dx a r 
erxiwateu	e rx i w a t eu 
tampi	t a m p i 
oree	o r ee 
anuppiyulxlxeeaam	a n u p p i y u lx lx ee aa m 
etirpaarkkappatxtxeen	e t i r p aa r k k a p p a tx tx ee n 
aparaatamaakac	a p a r aa t a m aa k a c 
sandtoosxattirxkeu	c a nd t oo sx a t t i rx k eu 
weerxeu	w ee rx eu 
keaalxlxa	k e aa lx lx a 
ekcarcais	e k c a r c ai s 
siwa	c i w a 
totxaata	t o tx aa t a 
miitum	m ii t u m 
ndakar	nd a k a r 
ndaan	nd aa n 
udxanee	u dx a n ee 
mutxiweu	m u tx i w eu 
widxa	w i dx a 
pitxikkum	p i tx i k k u m 
pitxikkala	p i tx i k k a l a 
suulam	c uu l a m 
seyyaweenxtxum	c e y y a w ee nx tx u m 
ulxlxanar	u lx lx a n a r 
ticaiyai	t i c ai y ai 
weerxa	w ee rx a 
patxeukkai	p a tx eu k k ai 
tulxi	t u lx i 
kurxitta	k u rx i t t a 
tatxaikalxai	t a tx ai k a lx ai 
kotxeukka	k o tx eu k k a 
kunxtxin	k u nx tx i n 
nduurxrxaanxtxeukalxeukkeu	nd uu rx rx aa nx tx eu k a lx eu k k eu 
witxeukirxeen	w i tx eu k i rx ee n 
seyalpaatxeukalx	c e y a l p aa tx eu k a lx 
maariyamman	m aa r i y a m m a n 
perxawillaiyenrxeu	p e rx a w i l l ai y e n rx eu 
ndaalxla	nd aa lx l a 
waangkala	w aa ng k a l a 
ndadxakkuteu	nd a dx a k k u t eu 
aanateu	aa n a t eu 
iicaana	ii c aa n a 
tirundta	t i r u nd t a 
urxutiyalxikkirxaar	u rx u t i y a lx i k k i rx aa r 
sellaarxrxalil	c e l l aa rx rx a l i l 
klxik	k lx i k 
ellaa	e l l aa 
txwiitxtxil	tx w ii tx tx i l 
ittakaiyeeaar	i t t a k ai y ee aa r 
uyirizhandtulxlxaar	u y i r i zh a nd t u lx lx aa r 
ewwalxaweu	e w w a lx a w eu 
pangkeu	p a ng k eu 
weenxtxi	w ee nx tx i 
kuzhi	k u zh i 
suwaril	c u w a r i l 
totxeu	t o tx eu 
waruwateu	w a r u w a t eu 
karai	k a r ai 
mutxtxap	m u tx tx a p 
teeykkap	t ee y k k a p 
anxi	a nx i 
karuwi	k a r u w i 
katxaikalxla	k a tx ai k a lx l a 
maatiriyaik	m aa t i r i y ai k 
ndatxaiperxuwateu	nd a tx ai p e rx u w a t eu 
patxindtireukkum	p a tx i nd t i r eu k k u m 
penxkalxai	p e nx k a lx ai 
kazhuwanxum	k a zh u w a nx u m 
witxaa	w i tx aa 
kuruwai	k u r u w ai 
arundteu	a r u nd t eu 
hanuman	h a n u m a n 
palli	p a l l i 
aacaiyaay	aa c ai y aa y 
aimpulan	ai m p u l a n 
enrxa	e n rx a 
patxtxanai	p a tx tx a n ai 
eerxpatxtxulxlxateu	ee rx p a tx tx u lx lx a t eu 
waatxcap	w aa tx c a p 
kaanxamutxiyawillai	k aa nx a m u tx i y a w i l l ai 
kurxippitxtxulxlxaar	k u rx i p p i tx tx u lx lx aa r 
suutxcamam	c uu tx c a m a m 
ahimcai	a h i m c ai 
siicanil	c ii c a n i l 
ndorxungki	nd o rx u ng k i 
samamaana	c a m a m aa n a 
kanrxeu	k a n rx eu 
maatxtxoom	m aa tx tx oo m 
poyyaanateu	p o y y aa n a t eu 
teetxi	t ee tx i 
piraccinai	p i r a c c i n ai 
ireukkiteu	i r eu k k i t eu 
munnaatxi	m u n n aa tx i 
kulxikkanxumuuttanxum	k u lx i k k a nx u m uu t t a nx u m 
wiitxtxula	w ii tx tx u l a 
weesxam	w ee sx a m 
nderuppil	nd e r u p p i l 
iruppeen	i r u p p ee n 
uudxakam	uu dx a k a m 
uuree	uu r ee 
waalx	w aa lx 
kawanittaan	k a w a n i t t aa n 
parxrxi	p a rx rx i 
kilxik	k i lx i k 
wilaiyinai	w i l ai y i n ai 
satxtxacapai	c a tx tx a c a p ai 
patrai	p a t r ai 
payanxikalx	p a y a nx i k a lx 
kalar	k a l a r 
pootxuween	p oo tx u w ee n 
puuceu	p uu c eu 
angkee	a ng k ee 
pappadxam	p a p p a dx a m 
iruppateu	i r u p p a t eu 
tiimaiyaic	t ii m ai y ai c 
maatiri	m aa t i r i 
seytaar	c e y t aa r 
pootxtxoo	p oo tx tx oo 
kutxumpam	k u tx u m p a m 
ootxtxamutxiyaateu	oo tx tx a m u tx i y aa t eu 
eerxpatxtxeu	ee rx p a tx tx eu 
seertteu	c ee r t t eu 
wekkam	w e k k a m 
suutxeu	c uu tx eu 
ozhittuwitxuwaar	o zh i t t u w i tx u w aa r 
utaweukirxateu	u t a w eu k i rx a t eu 
perum	p e r u m 
attumiirxal	a t t u m ii rx a l 
karaiyaik	k a r ai y ai k 
atxaikkappatxtxaar	a tx ai k k a p p a tx tx aa r 
kaatxtxungka	k aa tx tx u ng k a 
pisiyaa	p i s i y aa 
kooppai	k oo p p ai 
teriwittulxlxateu	t e r i w i t t u lx lx a t eu 
katiriyakka	k a t i r i y a k k a 
pirxpakalil	p i rx p a k a l i l 
oteukkiitxeu	o t eu k k ii tx eu 
kaiteu	k ai t eu 
paktiyootxeu	p a k t i y oo tx eu 
atarxkeu	a t a rx k eu 
aaloocikkappatxtxateu	aa l oo c i k k a p p a tx tx a t eu 
motta	m o t t a 
wazhakkin	w a zh a k k i n 
peukazh	p eu k a zh 
wiizhcci	w ii zh c c i 
teriyaateu	t e r i y aa t eu 
malaiyaalxam	m a l ai y aa lx a m 
kotxuttulxlxaar	k o tx u t t u lx lx aa r 
purindteu	p u r i nd t eu 
puuriyum	p uu r i y u m 
ndeyil	nd e y i l 
mottamaa	m o t t a m aa 
tazhii	t a zh ii 
patxutteuk	p a tx u t t eu k 
ireukkattaan	i r eu k k a t t aa n 
kitxaikkuteu	k i tx ai k k u t eu 
ndakarppurxa	nd a k a r p p u rx a 
keelxwi	k ee lx w i 
paanxtxing	p aa nx tx i ng 
miitxiyaawil	m ii tx i y aa w i l 
panjcam	p a nj c a m 
patxi	p a tx i 
tawarxeu	t a w a rx eu 
sandtiran	c a nd t i r a n 
kurxitteu	k u rx i t t eu 
kuutxtxattil	k uu tx tx a t t i l 
weetanai	w ee t a n ai 
enpaar	e n p aa r 
paadxacaalaikalxil	p aa dx a c aa l ai k a lx i l 
payanpatxuttikkolxlxalaamee	p a y a n p a tx u t t i k k o lx lx a l aa m ee 
arxiwippeu	a rx i w i p p eu 
yaareu	y aa r eu 
ndel	nd e l 
ndaatxeu	nd aa tx eu 
oolaiccuwatxi	oo l ai c c u w a tx i 
seluttinar	c e l u t t i n a r 
padxangkalxeukkeu	p a dx a ng k a lx eu k k eu 
meelum	m ee l u m 
munaiyaakum	m u n ai y aa k u m 
aayweukalx	aa y w eu k a lx 
kaaril	k aa r i l 
mikaccirxandta	m i k a c c i rx a nd t a 
padxattait	p a dx a t t ai t 
akal	a k a l 
waruttamum	w a r u t t a m u m 
indta	i nd t a 
kaalangkalxil	k aa l a ng k a lx i l 
wakaikalxoo	w a k ai k a lx oo 
kooppeu	k oo p p eu 
wazhakkam	w a zh a k k a m 
solleu	c o l l eu 
staapanam	s t aa p a n a m 
ndiiril	nd ii r i l 
porxuppeerxrxeu	p o rx u p p ee rx rx eu 
murxaiyaakac	m u rx ai y aa k a c 
atikaari	a t i k aa r i 
wizhundtitxtxirundtateu	w i zh u nd t i tx tx i r u nd t a t eu 
atuwee	a t u w ee 
patxippeu	p a tx i p p eu 
etaaccum	e t aa c c u m 
annaikkeu	a n n ai k k eu 
kuuzh	k uu zh 
ikkaraikkeu	i k k a r ai k k eu 
aacaiyaik	aa c ai y ai k 
perxrxateu	p e rx rx a t eu 
weenxtxaamee	w ee nx tx aa m ee 
welxiyee	w e lx i y ee 
ezhil	e zh i l 
walikkutuwalikkala	w a l i k k u t u w a l i k k a l a 
aancar	aa n c a r 
ndadxandtateu	nd a dx a nd t a t eu 
pirxarai	p i rx a r ai 
witiyai	w i t i y ai 
katxitam	k a tx i t a m 
tiitxtxaamee	t ii tx tx aa m ee 
putxittaal	p u tx i t t aa l 
arximeukam	a rx i m eu k a m 
inxaiyatalxattil	i nx ai y a t a lx a t t i l 
ulxundteu	u lx u nd t eu 
ais	ai s 
maatxiyila	m aa tx i y i l a 
pueukampam	p ueu k a m p a m 
suttamaaka	c u t t a m aa k a 
sandtaanam	c a nd t aa n a m 
ellaip	e l l ai p 
silar	c i l a r 
titxtxattin	t i tx tx a t t i n 
katxai	k a tx ai 
witxungka	w i tx u ng k a 
kaalxi	k aa lx i 
kurangkeu	k u r a ng k eu 
pitxi	p i tx i 
tawira	t a w i r a 
payilwatait	p a y i l w a t ai t 
murxiweukkeuk	m u rx i w eu k k eu k 
paarttaar	p aa r t t aa r 
matippaanateu	m a t i p p aa n a t eu 
aluwalarkalx	a l u w a l a r k a lx 
wareukirxoom	w a r eu k i rx oo m 
peaaruttiyireukkinrxanar	p e aa r u t t i y i r eu k k i n rx a n a r 
konxtxulxlxaar	k o nx tx u lx lx aa r 
turxaikalxeukkeu	t u rx ai k a lx eu k k eu 
talaiya	t a l ai y a 
sollit	c o l l i t 
liiweu	l ii w eu 
kampeuk	k a m p eu k 
katti	k a t t i 
patakkam	p a t a k k a m 
miinxtxum	m ii nx tx u m 
kanxkaanxitteu	k a nx k aa nx i t t eu 
wazhakkuppatiweu	w a zh a k k u p p a t i w eu 
pariceu	p a r i c eu 
haaspitxal	h aa s p i tx a l 
fiiwaraa	f ii w a r aa 
pitxicceukkoo	p i tx i c c eu k k oo 
mannan	m a n n a n 
onpateu	o n p a t eu 
meksikoo	m e k s i k oo 
kiloo	k i l oo 
keelxwikalxeukkeu	k ee lx w i k a lx eu k k eu 
todxarndteu	t o dx a r nd t eu 
kadxandta	k a dx a nd t a 
ndiingkalxee	nd ii ng k a lx ee 
ulakileeyee	u l a k i l ee y ee 
patxtxiyal	p a tx tx i y a l 
ruupaay	r uu p aa y 
walikkutaa	w a l i k k u t aa 
waangkitxtxiyaa	w aa ng k i tx tx i y aa 
ndoonjcaanaaka	nd oo nj c aa n aa k a 
arxiyaamai	a rx i y aa m ai 
paatxik	p aa tx i k 
wiitxeu	w ii tx eu 
maruttuwamanaiyil	m a r u t t u w a m a n ai y i l 
iruppaarkalx	i r u p p aa r k a lx 
atikam	a t i k a m 
mootxiyum	m oo tx i y u m 
pinwarum	p i n w a r u m 
pirxpakal	p i rx p a k a l 
ulxndaatxtxuc	u lx nd aa tx tx u c 
pala	p a l a 
ellaamee	e l l aa m ee 
ndapar	nd a p a r 
latxaak	l a tx aa k 
weelaikalxum	w ee l ai k a lx u m 
kuutxtxaatxci	k uu tx tx aa tx c i 
enakkaaka	e n a k k aa k a 
ndiiyum	nd ii y u m 
pookalayaa	p oo k a l a y aa 
onrxee	o n rx ee 
seytawan	c e y t a w a n 
waitteuk	w ai t t eu k 
teriwittulxlxataawateu	t e r i w i t t u lx lx a t aa w a t eu 
katxumaiyaaka	k a tx u m ai y aa k a 
wirumpeukirxoom	w i r u m p eu k i rx oo m 
ikkoowaikkeup	i k k oo w ai k k u p 
kalwi	k a l w i 
uyarndtulxlxateu	u y a r nd t u lx lx a t eu 
aantxani	aa n tx a n i 
putiya	p u t i y a 
sawaalkalxaic	c a w aa l k a lx ai c 
txepaacitx	tx e p aa c i tx 
iyalaata	i y a l aa t a 
awareukitxtxa	a w a r eu k i tx tx a 
muulam	m uu l a m 
illaiyeel	i l l ai y ee l 
atanai	a t a n ai 
rayilil	r a y i l i l 
tuuram	t uu r a m 
kaakitam	k aa k i t a m 
ndanmai	nd a n m ai 
enrxaar	e n rx aa r 
poor	p oo r 
kuzhandtaikalx	k u zh a nd t ai k a lx 
kuutxtxamaa	k uu tx tx a m aa 
tolainjceu	t o l ai nj c eu 
siirxum	c ii rx u m 
kalandteu	k a l a nd t eu 
waippataaka	w ai p p a t aa k a 
ulakalxawil	u l a k a lx a w i l 
wilxaiwikkak	w i lx ai w i k k a k 
waakkurxutiyai	w aa k k u rx u t i y ai 
kooyilin	k oo y i l i n 
tirumpik	t i r u m p i k 
suutxaakki	c uu tx aa k k i 
teewa	t ee w a 
pooliyaana	p oo l i y aa n a 
mai	m ai 
samaippateu	c a m ai p p a t eu 
maarkazhik	m aa r k a zh i k 
sindtikka	c i nd t i k k a 
takawal	t a k a w a l 
seytaarkalx	c e y t aa r k a lx 
tokutikalxil	t o k u t i k a lx i l 
solwateu	c o l w a t eu 
sutxitaar	c u tx i t aa r 
kayirxeu	k a y i rx eu 
sakariyaa	c a k a r i y aa 
tawikkak	t a w i k k a k 
alxikkum	a lx i k k u m 
kirikketx	k i r i k k e tx 
watxtxaaram	w a tx tx aa r a m 
marxakka	m a rx a k k a 
pe	p e 
paarkkanxum	p aa r k k a nx u m 
kuuppitxtxeu	k uu p p i tx tx eu 
waazhtteu	w aa zh t t eu 
mootiram	m oo t i r a m 
kaalxai	k aa lx ai 
pullait	p u l l ai t 
meelaalxaraaka	m ee l aa lx a r aa k a 
murxai	m u rx ai 
uuzhiyam	uu zh i y a m 
wazhangkappatxtxana	w a zh a ng k a p p a tx tx a n a 
watxakkuwatxakizhakkeu	w a tx a k k u w a tx a k i zh a k k eu 
tanmai	t a n m ai 
wiirarkalx	w ii r a r k a lx 
anaitteuk	a n ai t t eu k 
engka	e ng k a 
sxanxmeukak	sx a nx m eu k a k 
andtac	a nd t a c 
kuurxappatxtxulxlxateu	k uu rx a p p a tx tx u lx lx a t eu 
pooy	p oo y 
suutxkees	c uu tx k ee s 
uyir	u y i r 
kotxutta	k o tx u t t a 
saataaranxa	c aa t aa r a nx a 
tiruppa	t i r u p p a 
ulxaweu	u lx a w eu 
pootxtxooweukkeu	p oo tx tx oo w eu k k eu 
warutaa	w a r u t aa 
panxiweu	p a nx i w eu 
puttiyait	p u t t i y ai t 
siracil	c i r a c i l 
endtat	e nd t a t 
kulxiyal	k u lx i y a l 
txikketx	tx i k k e tx 
waangkuna	w aa ng k u n a 
sxeemamaaka	sx ee m a m aa k a 
paasxai	p aa sx ai 
asxtxalaksxmi	a sx tx a l a k sx m i 
uzhai	u zh ai 
sutandtirap	c u t a nd t i r a p 
titxtxam	t i tx tx a m 
katxtxangkalxaaka	k a tx tx a ng k a lx aa k a 
tarawaricaip	t a r a w a r i c ai p 
isxtxam	i sx tx a m 
keelxir	k ee lx i r 
etiraaka	e t i r aa k a 
pooteu	p oo t eu 
sanitxaicar	c a n i tx ai c a r 
purusxan	p u r u sx a n 
kadxam	k a dx a m 
iiram	ii r a m 
taramaana	t a r a m aa n a 
toolai	t oo l ai 
sampawa	c a m p a w a 
meerxkonxtxeu	m ee rx k o nx tx eu 
waruteu	w a r u t eu 
sari	c a r i 
panxnxitxtxiyaa	p a nx nx i tx tx i y aa 
poodxalaamaa	p oo dx a l aa m aa 
pilleu	p i l l eu 
meuka	m eu k a 
panxpeu	p a nx p eu 
ndirampiyateu	nd i r a m p i y a t eu 
mazhai	m a zh ai 
kurxi	k u rx i 
watxtxam	w a tx tx a m 
ungkalxeukkeu	u ng k a lx eu k k eu 
enpataakac	e n p a t aa k a c 
selutteukirxateu	c e l u t t eu k i rx a t eu 
weelxaanxmai	w ee lx aa nx m ai 
sirxappeu	c i rx a p p eu 
murxaikalx	m u rx ai k a lx 
rikki	r i k k i 
ndey	nd e y 
icai	i c ai 
wareukinrxanar	w a r eu k i n rx a n a r 
raajjiyam	r aa j j i y a m 
atxaiyaar	a tx ai y aa r 
pozhudaik	p o zh u d ai k 
peeccaaga	p ee c c aa g a 
araceu	a r a c eu 
ndaanggalx	nd aa ng g a lx 
surakkappadxum	c u r a k k a p p a dx u m 
kanxippeu	k a nx i p p eu 
maadxal	m aa dx a l 
manxattakkaalxi	m a nx a t t a k k aa lx i 
aracaangkattudxan	a r a c aa ng k a t t u dx a n 
ndakarin	nd a k a r i n 
waaram	w aa r a m 
marxrxawarkalxum	m a rx rx a w a r k a lx u m 
witxumurxai	w i tx u m u rx ai 
kulxi	k u lx i 
eengkum	ee ng k u m 
ndaanjcil	nd aa nj c i l 
wazhakkamaaka	w a zh a k k a m aa k a 
pootxtxiyidxa	p oo tx tx i y i dx a 
kaanxappatxeukirxateu	k aa nx a p p a tx eu k i rx a t eu 
awarum	a w a r u m 
wiwaranggalx	w i w a r a ng g a lx 
sirxandda	c i rx a nd d a 
keaalxlxum	k e aa lx lx u m 
baarada	b aa r a d a 
atxaiyaata	a tx ai y aa t a 
warxanxtxa	w a rx a nx tx a 
txicainla	tx i c ai n l a 
panddam	p a nd d a m 
sirxuwan	c i rx u w a n 
sakkaram	c a k k a r a m 
siiriyalgalx	c ii r i y a l g a lx 
payanpatxuttum	p a y a n p a tx u t t u m 
keetxtxaar	k ee tx tx aa r 
pakutiyileeyee	p a k u t i y i l ee y ee 
azhittuwidxum	a zh i t t u w i dx u m 
iiwining	ii w i n i ng 
wiik	w ii k 
uuril	uu r i l 
oocoonai	oo c oo n ai 
singgam	c i ng g a m 
kani	k a n i 
dudi	d u d i 
meel	m ee l 
teriyawanddulxlxadeu	t e r i y a w a nd d u lx lx a d eu 
parxaicaarxrxum	p a rx ai c aa rx rx u m 
alxawaana	a lx a w aa n a 
palappadxuttappatxtxirunddadeu	p a l a p p a dx u t t a p p a tx tx i r u nd d a d eu 
anxeu	a nx eu 
muunrxaawadeu	m uu n rx aa w a d eu 
amaiccakattai	a m ai c c a k a t t ai 
waasx	w aa sx 
raagi	r aa g i 
suwaiyaanadeu	c u w ai y aa n a d eu 
enxnxey	e nx nx e y 
ikazhaadee	i k a zh aa d ee 
