maambazham	m aa m b a zh a m
iiram	ii r a m
murxpagal	m u rx p a g a l
seyyin	s e y y i n
pirxpagal	p i rx p a g a l
wilxaiyum	w i lx ai y u m
en	e n
miideu	m ii d eu
koobam	k oo b a m
kolxlxaadee	k o lx lx aa d ee
sirxeu	s i rx eu
tulxi	t u lx i
pereu	p e r eu
welxlxam	w e lx lx a m
laksxmi	l a k sx m i
muga	m u g a
laksxanxam	l a k sx a nx a m
ulxlxa	u lx lx a
penx	p e nx
kaasxmiir	k aa sx m ii r
wadxakkeu	w a dx a k k eu
pagudiyil	p a g u d i y i l
ulxlxadeu	u lx lx a d eu
kanrxeu	k a n rx eu
unxaweukkeu	u nx a w eu k k eu
eenggum	ee ng g u m
ndunggeu	nd u ng g eu
inikkum	i n i k k u m
awasara	a w a s a r a
oli	o l i
ezhuppeu	e zh u p p eu
seywana	s e y w a n a
tirundda	t i r u nd d a
sey	s e y
pusxpam	p u sx p a m
ndaan	nd aa n
padxam	p a dx a m
tiiraakkoobam	t ii r aa k k oo b a m
pooraay	p oo r aa y
mudxiyum	m u dx i y u m
aadxaiyil	aa dx ai y i l
padxiwadeu	p a dx i w a d eu
karxai	k a rx ai
panjjeu	p a nj j eu
nderuppil	nd e r u p p i l
karugiyadeu	k a r u g i y a d eu
kadxawulxai	k a dx a w u lx ai
wanxanggeu	w a nx a ng g eu
paambeu	p aa m b eu
aaranjjeu	aa r a nj j eu
mitxtxaay	m i tx tx aa y
kattirikkaay	k a t t i r i k k aa y
aatxrxin	aa tx rx i n
ooram	oo r a m
karai	k a r ai
iiwadeu	ii w a d eu
ndalladeu	nd a l l a d eu
paanam	p aa n a m
siirxum	s ii rx u m
paambai	p aa m b ai
ndambaadee	nd a m b aa d ee
haasanam	h aa s a n a m
kucci	k u c c i
inippeu	i n i p p eu
suwai	s u w ai
kaayccaleukkeu	k aa y c c a l eu k k eu
suudxeu	s uu dx eu
kanjji	k a nj j i
sirxanddadeu	s i rx a nd d a d eu
raagam	r aa g a m
senggadir	s e ng g a d i r
kattiyait	k a t t i y ai t
tiitxtxaamee	t ii tx tx aa m ee
puttiyait	p u t t i y ai t
tiitxtxeu	t ii tx tx eu
tolaikkaatxci	t o l ai k k aa tx c i
oreu	o r eu
uudxagam	uu dx a g a m
accamillaadawan	a c c a m i l l aa d a w a n
ambalam	a m b a l a m
eerxuwaan	ee rx u w aa n
anaittum	a n ai t t u m
adxanggiya	a dx a ng g i y a
toguppeu	t o g u p p eu
suuranxam	s uu r a nx a m
yaanai	y aa n ai
pilxirxum	p i lx i rx u m
karumbeu	k a r u m b eu
kuranggeu	k u r a ng g eu
panddai	p a nd d ai
erxinddadeu	e rx i nd d a d eu
etxtxeukkaali	e tx tx eu k k aa l i
puucci	p uu c c i
sittiramum	s i t t i r a m u m
kaip	k ai p
pazhakkam	p a zh a k k a m
raagi	r aa g i
poosxaakkaana	p oo sx aa k k aa n a
unxaweu	u nx a w eu
kanddaiyaanaalum	k a nd d ai y aa n aa l u m
kasakkik	k a s a k k i k
katxtxeu	k a tx tx eu
kaagidam	k aa g i d a m
anggee	a ng g ee
inggee	i ng g ee
paarkkaadee	p aa r k k aa d ee
ndaadam	nd aa d a m
mazhai	m a zh ai
mugam	m u g a m
kaanxaada	k aa nx aa d a
payirxeu	p a y i rx eu
uruppadxaadeu	u r u p p a dx aa d eu
oolaiccuwadxi	oo l ai c c u w a dx i
padxi	p a dx i
paappaa	p aa p p aa
paar	p aa r
taraadaram	t a r aa d a r a m
wallawaneukkeup	w a l l a w a n eu k k eu p
pullum	p u l l u m
aayudam	aa y u d a m
iisaana	ii s aa n a
muulaiyil	m uu l ai y i l
amaraadee	a m a r aa d ee
paarttaal	p aa r t t aa l
puunai	p uu n ai
paaynddaal	p aa y nd d aa l
puli	p u l i
pagal	p a g a l
eppozhudum	e p p o zh u d u m
sanddoosxamaaga	s a nd d oo sx a m aa g a
iruppeen	i r u p p ee n
panjjaanggam	p a nj j aa ng g a m
meegam	m ee g a m
asuran	a s u r a n
tawam	t a w a m
irunddaan	i r u nd d aa n
paagam	p aa g a m
kurxi	k u rx i
pirxareukkeu	p i rx a r eu k k eu
suuniyam	s uu n i y a m
seyyaadee	s e y y aa d ee
ndaatxtxil	nd aa tx tx i l
tanxnxiir	t a nx nx ii r
panjjam	p a nj j a m
ndilawiyadeu	nd i l a w i y a d eu
kudxisai	k u dx i s ai
tiiyaal	t ii y aa l
erinddadeu	e r i nd d a d eu
sanggeu	s a ng g eu
samiibamaaga	s a m ii b a m aa g a
peydadeu	p e y d a d eu
elumbeu	e l u m b eu
majjai	m a j j ai
waliyadeu	w a l i y a d eu
puliyaip	p u l i y ai p
paartteu	p aa r t t eu
anjjeu	a nj j eu
kadxam	k a dx a m
sxasxtxi	sx a sx tx i
uurudxan	uu r u dx a n
waazh	w aa zh
saalaiyil	s aa l ai y i l
ndiir	nd ii r
ndirambiyadeu	nd i r a m b i y a d eu
ikkaraikkeu	i k k a r ai k k eu
akkaraip	a k k a r ai p
paccai	p a c c ai
ammaa	a m m aa
samaippadeu	s a m ai p p a d eu
karxi	k a rx i
suudxaamanxi	s uu dx aa m a nx i
paattirattil	p aa t t i r a t t i l
iiyam	ii y a m
puuseu	p uu s eu
koowil	k oo w i l
gooburam	g oo b u r a m
uyaramaanadeu	u y a r a m aa n a d eu
tanddai	t a nd d ai
uukkamee	uu k k a m ee
peeseu	p ee s eu
kaalxi	k aa lx i
suulam	s uu l a m
eenddinaan	ee nd d i n aa n
aarjidam	aa r j i d a m
puurwa	p uu r w a
jenma	j e n m a
banddam	b a nd d a m
mayil	m a y i l
agawum	a g a w u m
kuudxi	k uu dx i
waazhnddaal	w aa zh nd d aa l
koodxi	k oo dx i
ndanmai	nd a n m ai
nduraiyiiral	nd u r ai y ii r a l
minnuwadeu	m i n n u w a d eu
ellaam	e l l aa m
pon	p o n
alla	a l l a
patxtxaam	p a tx tx aa m
pidxi	p i dx i
un	u n
poliwaaga	p o l i w aa g a
porulx	p o r u lx
pazhagaadee	p a zh a g aa d ee
toosxattirxkeu	t oo sx a t t i rx k eu
parigaaram	p a r i g aa r a m
pazhanggudxi	p a zh a ng g u dx i
makkalx	m a k k a lx
panxbeu	p a nx b eu
sirxappeu	s i rx a p p eu
patxtxeu	p a tx tx eu
parambarai	p a r a m b a r ai
mannan	m a n n a n
kiriidxam	k i r ii dx a m
idxa	i dx a
odeukkiidxeu	o d eu k k ii dx eu
padxar	p a dx a r
ooywinrxi	oo y w i n rx i
uzhai	u zh ai
panjjaayatteu	p a nj j aa y a t t eu
wazhakkeu	w a zh a k k eu
mudxiweukkeu	m u dx i w eu k k eu
wanddadeu	w a nd d a d eu
muyarxci	m u y a rx c i
tarum	t a r u m
otxrxumaiyee	o tx rx u m ai y ee
balam	b a l a m
manam	m a n a m
tirxanddeu	t i rx a nd d eu
saambal	s aa m b a l
kari	k a r i
pal	p a l
tulakka	t u l a k k a
udawum	u d a w u m
raamar	r aa m a r
aajar	aa j a r
aanaar	aa n aa r
tuukkam	t uu k k a m
udxaleukkeu	u dx a l eu k k eu
madippenx	m a d i p p e nx
oppiidxeu	o p p ii dx eu
tawarxeu	t a w a rx eu
maadulxai	m aa d u lx ai
enakkeu	e n a k k eu
njaabaga	nj aa b a g a
marxadi	m a rx a d i
unxdxeu	u nx dx eu
katxtxam	k a tx tx a m
awan	a w a n
eezhai	ee zh ai
illai	i l l ai
sanggee	s a ng g ee
muzhanggeu	m u zh a ng g eu
pariseu	p a r i s eu
waitteuk	w ai t t eu k
kootxtxai	k oo tx tx ai
katxtxaadee	k a tx tx aa d ee
saami	s aa m i
asxtxalaksxmi	a sx tx a l a k sx m i
puujai	p uu j ai
ndalamalxikkum	nd a l a m a lx i k k u m
kuyil	k u y i l
kuuwum	k uu w u m
deesiya	d ee s i y a
panggeu	p a ng g eu
uyarnddadeu	u y a r nd d a d eu
bayam	b a y a m
ndiikkeu	nd ii k k eu
inggeu	i ng g eu
tangguwadarxkeu	t a ng g u w a d a rx k eu
ilawasam	i l a w a s a m
pappadxam	p a p p a dx a m
iratxtxai	i r a tx tx ai
suzhi	s u zh i
sirxuwan	s i rx u w a n
seetxtxai	s ee tx tx ai
seywaan	s e y w aa n
winjnjaana	w i nj nj aa n a
walxarcci	w a lx a r c c i
ndaatxtxeu	nd aa tx tx eu
inrxeu	i n rx eu
palxlxiyil	p a lx lx i y i l
ezhutteup	e zh u t t eu p
pootxtxi	p oo tx tx i
widiyai	w i d i y ai
miirxinaal	m ii rx i n aa l
abaraadam	a b a r aa d a m
kanxidam	k a nx i d a m
kanxnxeukkeu	k a nx nx eu k k eu
mai	m ai
azhageu	a zh a g eu
waazhkkai	w aa zh k k ai
kasxtxam	k a sx tx a m
ndirxainddadeu	nd i rx ai nd d a d eu
kariim	k a r ii m
tusxtxan	t u sx tx a n
tusxtxa	t u sx tx a
seyal	s e y a l
patxtxam	p a tx tx a m
eerxpadeu	ee rx p a d eu
igazhcci	i g a zh c c i
daaniyam	d aa n i y a m
onrxaam	o n rx aa m
ndanrxaaga	nd a n rx aa g a
irunddadeu	i r u nd d a d eu
talaiwar	t a l ai w a r
warugai	w a r u g ai
uurjidam	uu r j i d a m
aanadeu	aa n a d eu
tazhii	t a zh ii
sidambaram	s i d a m b a r a m
njaayirxeu	nj aa y i rx eu
widxumurxai	w i dx u m u rx ai
kadxai	k a dx ai
adxaippeu	a dx ai p p eu
kanx	k a nx
matxtxam	m a tx tx a m
tatxtxaamee	t a tx tx aa m ee
panxiweu	p a nx i w eu
kalwiyee	k a l w i y ee
sirxandda	s i rx a nd d a
selwam	s e l w a m
iwalx	i w a lx
peyar	p e y a r
usxaa	u sx aa
sendndiir	s e nd nd ii r
kalwi	k a l w i
isxtxam	i sx tx a m
pool	p oo l
waazhalaam	w aa zh a l aa m
taniyaa	t a n i y aa
widxaa	w i dx aa
ndaanjjil	nd aa nj j i l
saram	s a r a m
otxtxeuk	o tx tx eu k
keetxpadeu	k ee tx p a d eu
wilxaiyaatxtxeu	w i lx ai y aa tx tx eu
uukkam	uu k k a m
mannarai	m a n n a r ai
waazhttinaargalx	w aa zh t t i n aa r g a lx
kaatxrxulxlxa	k aa tx rx u lx lx a
poodee	p oo d ee
tuutxrxikkolx	t uu tx rx i k k o lx
uuham	uu h a m
ndooyatxrxa	nd oo y a tx rx a
waazhwee	w aa zh w ee
kurxaiwatxrxa	k u rx ai w a tx rx a
suuriyan	s uu r i y a n
olxi	o lx i
weppam	w e p p a m
usxnxam	u sx nx a m
adigam	a d i g a m
udxaiyaar	u dx ai y aa r
adxaiyaar	a dx ai y aa r
ozheukkamaaga	o zh eu k k a m aa g a
ireu	i r eu
sirxuwar	s i rx u w a r
padxippadeu	p a dx i p p a d eu
palxlxi	p a lx lx i
malar	m a l a r
tuuwi	t uu w i
waazhtteu	w aa zh t t eu
saasxtxaanggam	s aa sx tx aa ng g a m
wizhunddeu	w i zh u nd d eu
suwaril	s u w a r i l
uurwadeu	uu r w a d eu
palli	p a l l i
tadxaagam	t a dx aa g a m
adirsxtxam	a d i r sx tx a m
biins	b ii n s
oruwagai	o r u w a g ai
kaay	k aa y
njaalam	nj aa l a m
seewalin	s ee w a l i n
kuuwalil	k uu w a l i l
pozhudeu	p o zh u d eu
widxiyum	w i dx i y u m
bakti	b a k t i
suutxcamam	s uu tx c a m a m
arxinddeu	a rx i nd d eu
seyalpadxeu	s e y a l p a dx eu
eepral	ee p r a l
maada	m aa d a
lajjai	l a j j ai
enrxaal	e n rx aa l
wekkam	w e k k a m
sutxrxeu	s u tx rx eu
suuzhal	s uu zh a l
sugaadaaram	s u g aa d aa r a m
pinpatxrxeu	p i n p a tx rx eu
unggalx	u ng g a lx
wiidxeu	w ii dx eu
enggeu	e ng g eu
onbadeu	o n b a d eu
koolxgalx	k oo lx g a lx
puujaiyil	p uu j ai y i l
kalanddeu	k a l a nd d eu
kolx	k o lx
eelakkaay	ee l a k k aa y
ndarxumanxam	nd a rx u m a nx a m
anjjal	a nj j a l
ndilaiyam	nd i l ai y a m
sanddiran	s a nd d i r a n
uccam	u c c a m
todxeu	t o dx eu
tiidum	t ii d u m
ndanrxum	nd a n rx u m
pirxar	p i rx a r
tara	t a r a
waaraa	w aa r aa
aanggilam	aa ng g i l a m
mozhi	m o zh i
taajmahaalai	t aa j m a h aa l ai
katxtxiyawar	k a tx tx i y a w a r
sxaajagaan	sx aa j a g aa n
pirxarai	p i rx a r ai
igazhaadee	i g a zh aa d ee
danusxkoodxi	d a n u sx k oo dx i
katxrxeut	k a tx rx eu t
taruween	t a r u w ee n
karuttaranggam	k a r u t t a r a ng g a m
harisxtxam	h a r i sx tx a m
injji	i nj j i
maruttuwa	m a r u t t u w a
gunxam	g u nx a m
waaynddadeu	w aa y nd d a d eu
kaanjjipuram	k aa nj j i p u r a m
padakkam	p a d a k k a m
adxakkamee	a dx a k k a m ee
widxuwadeu	w i dx u w a d eu
kaalai	k aa l ai
unxmaiyee	u nx m ai y ee
kanxini	k a nx i n i
kadxidam	k a dx i d a m
purusxan	p u r u sx a n
balasaali	b a l a s aa l i
kambeu	k a m b eu
magudxi	m a g u dx i
aatxrxil	aa tx rx i l
waruwadeu	w a r u w a d eu
aasaiyaik	aa s ai y ai k
kurxai	k u rx ai
raajjiyam	r aa j j i y a m
weenxdxum	w ee nx dx u m
padxa	p a dx a
ndaagam	nd aa g a m
ndaanxam	nd aa nx a m
manxal	m a nx a l
kedxuwaan	k e dx u w aa n
keedxeu	k ee dx eu
ndinaippaan	nd i n ai p p aa n
tatruubamaaga	t a t r uu b a m aa g a
ndadxitteuk	nd a dx i t t eu k
kaatxtxa	k aa tx tx a
njaanam	nj aa n a m
teewai	t ee w ai
ootxtxai	oo tx tx ai
idxeu	i dx eu
iranxdxeu	i r a nx dx eu
puunxdxeu	p uu nx dx eu
tii	t ii
muutxtxi	m uu tx tx i
wibatteu	w i b a t t eu
ndadxanddadeu	nd a dx a nd d a d eu
rambam	r a m b a m
kaanxbadeu	k aa nx b a d eu
een	ee n
ippadxi	i p p a dx i
ndoonjjaanaaga	nd oo nj j aa n aa g a
ireukkaan	i r eu k k aa n
amaiccar	a m ai c c a r
wanddaar	w a nd d aa r
amsanggalx	a m s a ng g a lx
pakkam	p a k k a m
kalagam	k a l a g a m
pirxanddaal	p i rx a nd d aa l
ndiyaayam	nd i y aa y a m
pirxakkum	p i rx a k k u m
siikkiram	s ii k k i r a m
eerxpaadxeu	ee rx p aa dx eu
tanggalx	t a ng g a lx
udxaimai	u dx ai m ai
gawanam	g a w a n a m
selutteu	s e l u t t eu
kanxnxiir	k a nx nx ii r
anjjali	a nj j a l i
seluttinar	s e l u t t i n a r
moodiram	m oo d i r a m
togudi	t o g u d i
hetx	h e tx
sanddippeu	s a nd d i p p eu
pooliyaana	p oo l i y aa n a
tawir	t a w i r
arunddeu	a r u nd d eu
eerikkeu	ee r i k k eu
appaal	a p p aa l
sakkaram	s a k k a r a m
ndanrxi	nd a n rx i
pootxtxaalum	p oo tx tx aa l u m
alxanddeu	a lx a nd d eu
poodxeu	p oo dx eu
hastam	h a s t a m
maargazhik	m aa r g a zh i k
kulxir	k u lx i r
kunggumam	k u ng g u m a m
siwappeu	s i w a p p eu
ajiiranxak	a j ii r a nx a k
koolxaarxeu	k oo lx aa rx eu
maarc	m aa r c
maadattil	m aa d a t t i l
mahaawiir	m a h aa w ii r
jeyanddi	j e y a nd d i
enggalx	e ng g a lx
baaradam	b aa r a d a m
kaigalxai	k ai g a lx ai
inxai	i nx ai
ndadxai	nd a dx ai
ozhunggeu	o zh u ng g eu
tozhilil	t o zh i l i l
muuladanam	m uu l a d a n a m
poodxa	p oo dx a
kiizhoor	k ii zh oo r
aayinum	aa y i n u m
taazha	t aa zh a
urai	u r ai
seyaleukkeut	s e y a l eu k k eu t
tiirweu	t ii r w eu
kaanxeu	k aa nx eu
taay	t aa y
ndiinggalx	nd ii ng g a lx
sxeemamaaga	sx ee m a m aa g a
irunggalx	i r u ng g a lx
jeyhindd	j e y h i nd d
enrxeu	e n rx eu
kuurxeu	k uu rx eu
teejas	t ee j a s
aasaiyaay	aa s ai y aa y
tinbadeu	t i n b a d eu
wellam	w e l l a m
tootxtxattai	t oo tx tx a t t ai
gawani	g a w a n i
wiidi	w ii d i
wazhiyaaga	w a zh i y aa g a
sellum	s e l l u m
peerunddeu	p ee r u nd d eu
pasittaalum	p a s i t t aa l u m
pullait	p u l l ai t
tinnaadeu	t i n n aa d eu
amaanusxiyam	a m aa n u sx i y a m
ndirxaindda	nd i rx ai nd d a
idxam	i dx a m
tanggam	t a ng g a m
paambin	p aa m b i n
ndanjjeu	nd a nj j eu
kodxiyadeu	k o dx i y a d eu
puttagam	p u t t a g a m
janamee	j a n a m ee
ndam	nd a m
marattai	m a r a t t ai
arxuppadeu	a rx u p p a d eu
waalx	w aa lx
risxikkeu	r i sx i k k eu
roosxam	r oo sx a m
saarxeu	s aa rx eu
urxinjji	u rx i nj j i
manjjalx	m a nj j a lx
tuulx	t uu lx
miin	m ii n
waarattin	w aa r a t t i n
mudal	m u d a l
ndaalx	nd aa lx
tinggalx	t i ng g a lx
katti	k a t t i
janawari	j a n a w a r i
maadam	m aa d a m
karam	k a r a m
siwaneukkeu	s i w a n eu k k eu
abisxeegam	a b i sx ee g a m
seydanar	s e y d a n a r
agal	a g a l
watxtxam	w a tx tx a m
anbee	a n b ee
kadxawulx	k a dx a w u lx
wiitxtxil	w ii tx tx i l
wiseesxam	w i s ee sx a m
pambaram	p a m b a r a m
suzhatxrxeu	s u zh a tx rx eu
sarppam	s a r p p a m
ndiidxikkum	nd ii dx i k k u m
ilxamaiyil	i lx a m ai y i l
kal	k a l
manx	m a nx
waasanai	w aa s a n ai
ezhil	e zh i l
migundda	m i g u nd d a
waanam	w aa n a m
onrxee	o n rx ee
kulam	k u l a m
jaadi	j aa d i
senddamizhum	s e nd d a m i zh u m
ndaappazhakkam	nd aa p p a zh a k k a m
tanggattin	t a ng g a t t i n
wilai	w i l ai
inddiyaawin	i nd d i y aa w i n
talaindagaram	t a l ai nd a g a r a m
txelli	tx e l l i
baktiyoodxeu	b a k t i y oo dx eu
sanggamam	s a ng g a m a m
kani	k a n i
pagalawan	p a g a l a w a n
padxitteup	p a dx i t t eu p
perxeu	p e rx eu
taagam	t aa g a m
ndari	nd a r i
uulxaiyidxum	uu lx ai y i dx u m
guruwai	g u r u w ai
sisxyan	s i sx y a n
wanxangginaan	w a nx a ng g i n aa n
kasxaayam	k a sx aa y a m
jagam	j a g a m
pazham	p a zh a m
petxtxiyai	p e tx tx i y ai
kiizhee	k ii zh ee
kayirxeu	k a y i rx eu
agattin	a g a t t i n
mugattil	m u g a t t i l
teriyum	t e r i y u m
insol	i n s o l
iyambeu	i y a m b eu
waay	w aa y
jaalam	j aa l a m
kaatxtxum	k aa tx tx u m
manidan	m a n i d a n
kadai	k a d ai
sol	s o l
muulxai	m uu lx ai
illaadawan	i l l aa d a w a n
mutxtxaalx	m u tx tx aa lx
hanuman	h a n u m a n
aktxoobar	a k tx oo b a r
gaanddi	g aa nd d i
illaiyadxi	i l l ai y a dx i
yaadum	y aa d u m
uuree	uu r ee
yaawarum	y aa w a r u m
keelxir	k ee lx i r
bajanai	b a j a n ai
migawum	m i g a w u m
pirabalam	p i r a b a l a m
adxaadeu	a dx aa d eu
seydawan	s e y d a w a n
padxaadeu	p a dx aa d eu
padxuwaan	p a dx u w aa n
tambi	t a m b i
tamizh	t a m i zh
taa	t aa
padxeukkai	p a dx eu k k ai
samacciir	s a m a c c ii r
murxaiyaanadeu	m u rx ai y aa n a d eu
ahimsai	a h i m s ai
wazhiyaip	w a zh i y ai p
eetxrxam	ee tx rx a m
alxaweukkeu	a lx a w eu k k eu
minjjinaal	m i nj j i n aa l
amudamum	a m u d a m u m
wisxam	w i sx a m
kutxtxaiyil	k u tx tx ai y i l
teenggiyadeu	t ee ng g i y a d eu
purxaa	p u rx aa
tuudeu	t uu d eu
anuppa	a n u p p a
tolai	t o l ai
duuram	d uu r a m
parxanddadeu	p a rx a nd d a d eu
sotteu	s o t t eu
jadxai	j a dx ai
pinni	p i n n i
weesxam	w ee sx a m
teruwil	t e r u w i l
koosxam	k oo sx a m
ezhuppaadee	e zh u p p aa d ee
tozhil	t o zh i l
oppudal	o p p u d a l
wandda	w a nd d a
wisxayattaik	w i sx a y a t t ai k
kaalaiyil	k aa l ai y i l
ezheu	e zh eu
aidiigam	ai d ii g a m
peesaadee	p ee s aa d ee
ganxeesx	g a nx ee sx
ganxeesanait	g a nx ee s a n ai t
tudi	t u d i
eewuganxai	ee w u g a nx ai
eenddeu	ee nd d eu
panxdxam	p a nx dx a m
kuurnddeu	k uu r nd d eu
lanjja	l a nj j a
ozhippeu	o zh i p p eu
satxtxam	s a tx tx a m
ndalla	nd a l l a
kitxtxawanddaal	k i tx tx a w a nd d aa l
mutxtxap	m u tx tx a p
pagai	p a g ai
toonrxiya	t oo n rx i y a
pugazhin	p u g a zh i n
toonrxuga	t oo n rx u g a
indda	i nd d a
raajaa	r aa j aa
endda	e nd d a
baasxai	b aa sx ai
peesinaar	p ee s i n aa r
aimpulan	ai m p u l a n
adxakkeu	a dx a k k eu
kudxumbam	k u dx u m b a m
kadambam	k a d a m b a m
buwaneesxwar	b u w a n ee sx w a r
uuril	uu r i l
puugambam	p uu g a m b a m
jalam	j a l a m
enxnxey	e nx nx e y
teeytteuk	t ee y t t eu k
kulxi	k u lx i
sxanxmugak	sx a nx m u g a k
kawasam	k a w a s a m
adxuppil	a dx u p p i l
erxiwadeu	e rx i w a d eu
maatxtxeukkeu	m aa tx tx eu k k eu
iruppadeu	i r u p p a d eu
waal	w aa l
singgam	s i ng g a m
garjikkum	g a r j i k k u m
maiyanggalx	m ai y a ng g a lx
wanxdxi	w a nx dx i
izhuppadeu	i zh u p p a d eu
kaalxai	k aa lx ai
jagattinai	j a g a t t i n ai
azhittidxuwoom	a zh i t t i dx u w oo m
senggai	s e ng g ai
kambeuk	k a m b eu k
kuuzh	k uu zh
suwaiyaanadeu	s u w ai y aa n a d eu
elximaiyaay	e lx i m ai y aa y
ndaay	nd aa y
kuzhi	k u zh i
toonxdxiyadeu	t oo nx dx i y a d eu
otxtxagam	o tx tx a g a m
wilanggeu	w i l a ng g eu
meejai	m ee j ai
meel	m ee l
eerxi	ee rx i
ndil	nd i l
poodum	p oo d u m
enrxa	e n rx a
manamee	m a n a m ee
seyyum	s e y y u m
marunddeu	m a r u nd d eu
jaalraa	j aa l r aa
weenxdxaam	w ee nx dx aa m
banggalxaadeesx	b a ng g a lx aa d ee sx
ndaadxeu	nd aa dx eu
punidam	p u n i d a m
adeu	a d eu
uur	uu r
ndacceup	nd a c c eu p
pugai	p u g ai
oosoonai	oo s oo n ai
baadikkum	b aa d i k k u m
anxnxaa	a nx nx aa
waa	w aa
wibattil	w i b a t t i l
uunam	uu n a m
senggamalam	s e ng g a m a l a m
unxmai	u nx m ai
kai	k ai
kodxeukkum	k o dx eu k k u m
eetxtxeu	ee tx tx eu
suraikkaay	s u r ai k k aa y
karxikkeu	k a rx i k k eu
udawaadeu	u d a w aa d eu
sil	sil
!SIL	sil
